211 15
128 352
0564 0564 0564 0564 0564 0564 0564 0564 0564 0564 0564 0564 0564 0564 0564 0564 0564 0564 0564 0564 0564 0564 0564 0564 0564 0564 0564 0564 0564 0564 0564 0564 0564 0564 0564 0564 0564 0564 0564 0564 0564 0564 0564 0564 0564 0564 0564 0564 0564 0564 0564 0564 0564 0564 0564 0564 0564 0564 0564 0564 0564 0564 0564 0564 0564 0564 0564 0564 0564 0564 0564 0564 0564 0564 0564 0564 0564 0564 0564 0564 0564 0564 0564 0564 0564 0564 0564 0564 0564 0564 0564 0564 0564 0564 0564 0564 0564 0564 0564 0564 0564 0564 0564 0564 0564 0564 0564 0564 0564 0564 0564 0564 0564 0564 0564 0564 0564 0564 0564 0564 0564 0564 0564 0564 0564 0564 0564 0564 0564 0564 0564 0564 0564 0564 0564 0564 0564 0564 0564 0564 0564 0564 0564 0564 0564 0564 0564 0564 0564 0564 0564 0564 0564 0564 0564 0564 0564 0564 0564 0564 0564 0564 0564 0564 0564 0564 0564 0564 0564 0564 0564 0564 0564 0564 0564 0564 0564 0564 0564 0564 0564 0564 0564 0564 0564 0564 0564 0564 0564 0564 0564 0564 0564 0564 0564 0564 0564 0564 0564 0564 0564 0564 0564 0564 0564 0564 0564 0564 0564 0564 0564
0564 0564 0564 0564 0564 0564 0564 0564 0564 0564 0564 0564 0564 0564 0564 0564 0564 0564 0564 0564 0564 0564 0564 0564 0564 0564 0564 0564 0564 0564 0564 0564 0564 0564 0564 0564 0564 0564 0564 0564 0564 0564 0564 0564 0564 0564 0564 0564 0564 0564 0564 0564 0564 0564 0564 0564 0564 0564 0564 0564 0564 0564 0564 0564 0564 0564 0564 0564 0564 0564 0564 0564 0564 0564 0564 0564 0564 0564 0564 0564 0564 0564 0564 0564 0564 0564 0564 0564 0564 0564 0564 0564 0564 0564 0564 0564 0564 0564 0564 0564 0564 0564 0564 0564 0564 0564 0564 0564 0564 0564 0564 0564 0564 0564 0564 0564 0564 0564 0564 0564 0564 0564 0564 0564 0564 0564 0564 0564 0564 0564 0564 0564 0564 0564 0564 0564 0564 0564 0564 0564 0564 0564 0564 0564 0564 0564 0564 0564 0564 0564 0564 0564 0564 0564 0564 0564 0564 0564 0564 0564 0564 0564 0564 0564 0564 0564 0564 0564 0564 0564 0564 0564 0564 0564 0564 0564 0564 0564 0564 0564 0564 0564 0564 0564 0564 0564 0564 0564 0564 0564 0564 0564 0564 0564 0564 0564 0564 0564 0564 0564 0564 0564 0564 0564 0564 0564 0564 0564 0564 0564 0564
0564 0564 0564 0564 0564 0564 0564 0564 0564 0564 0564 0564 0564 0564 0564 0564 0564 0564 0550 0551 0552 0564 0564 0564 0564 0564 0564 0564 0564 0564 0564 0564 0564 0564 0564 0550 0551 0551 0552 0564 0564 0564 0564 0564 0564 0564 0564 0564 0564 0564 0564 0564 0564 0564 0564 0564 0564 0564 0564 0564 0564 0564 0564 0564 0564 0564 0550 0551 0552 0564 0564 0564 0564 0564 0564 0564 0564 0564 0564 0564 0564 0564 0564 0550 0551 0551 0552 0564 0564 0564 0564 0564 0564 0564 0564 0564 0564 0564 0564 0564 0564 0564 0564 0564 0564 0564 0564 0564 0564 0564 0564 0564 0564 0564 0550 0551 0552 0564 0564 0564 0564 0564 0564 0564 0564 0564 0564 0564 0564 0564 0564 0550 0551 0551 0552 0564 0564 0564 0564 0564 0564 0564 0564 0564 0564 0564 0564 0564 0564 0564 0564 0564 0564 0564 0564 0564 0564 0564 0564 0564 0564 0564 0550 0551 0552 0564 0564 0564 0564 0564 0564 0564 0564 0564 0564 0564 0564 0564 0564 0550 0551 0551 0552 0564 0564 0564 0564 0564 0564 0564 0564 0564 0564 0564 0564 0564 0564 0225 0564 0564 0564 0564 0564 0564 0564 0564 0564 0564 0564 0564 0564
0564 0564 0564 0564 0564 0564 0564 0564 0564 0564 0564 0564 0564 0564 0564 0564 0564 0564 0561 0562 0563 0564 0564 0564 0564 0564 0550 0551 0551 0551 0552 0564 0564 0564 0564 0561 0562 0562 0563 0564 0564 0564 0564 0564 0564 0564 0564 0564 0564 0564 0564 0564 0564 0564 0564 0550 0551 0552 0564 0564 0564 0564 0564 0564 0564 0564 0561 0562 0563 0564 0564 0564 0564 0564 0550 0551 0551 0551 0552 0564 0564 0564 0564 0561 0562 0562 0563 0564 0564 0564 0564 0564 0564 0564 0564 0564 0564 0564 0564 0564 0564 0564 0564 0550 0551 0552 0564 0564 0564 0564 0564 0564 0564 0564 0561 0562 0563 0564 0564 0564 0564 0564 0550 0551 0551 0551 0552 0564 0564 0564 0564 0561 0562 0562 0563 0564 0564 0564 0564 0564 0564 0564 0564 0564 0564 0564 0564 0564 0564 0564 0564 0550 0551 0552 0564 0564 0564 0564 0564 0564 0564 0564 0561 0562 0563 0564 0564 0564 0564 0564 0550 0551 0551 0551 0552 0564 0564 0564 0564 0561 0562 0562 0563 0564 0564 0564 0564 0564 0564 0564 0564 0564 0564 0564 0564 0564 0564 0288 0564 0550 0551 0552 0564 0564 0564 0564 0564 0564 0564 0564 0564
0564 0564 0564 0564 0564 0564 0564 0564 0564 0564 0564 0564 0564 0564 0564 0564 0564 0564 0564 0564 0564 0564 0564 0564 0564 0564 0561 0562 0562 0562 0563 0564 0564 0564 0564 0564 0564 0564 0564 0564 0564 0564 0564 0564 0564 0564 0564 0564 0564 0564 0564 0564 0564 0564 0564 0561 0562 0563 0564 0564 0564 0564 0564 0564 0564 0564 0564 0564 0564 0564 0564 0564 0564 0564 0561 0562 0562 0562 0563 0564 0564 0564 0564 0564 0564 0564 0564 0564 0564 0564 0564 0564 0564 0564 0564 0564 0564 0564 0564 0564 0564 0564 0564 0561 0562 0563 0564 0564 0564 0564 0564 0564 0564 0564 0564 0564 0564 0564 0564 0564 0564 0564 0561 0562 0562 0562 0563 0564 0564 0564 0564 0564 0564 0564 0564 0564 0564 0564 0564 0564 0564 0564 0564 0564 0564 0564 0564 0564 0564 0564 0564 0561 0562 0563 0564 0564 0564 0564 0564 0564 0564 0564 0564 0564 0564 0564 0564 0564 0564 0564 0561 0562 0562 0562 0563 0564 0564 0564 0564 0564 0564 0564 0564 0564 0564 0564 0564 0564 0564 0564 0564 0564 0564 0564 0564 0564 0564 0286 0564 0561 0562 0563 0564 0564 0564 0564 0564 0564 0564 0564 0564
0564 0564 0564 0564 0564 0564 0564 0564 0564 0564 0564 0564 0564 0564 0564 0564 0564 0564 0564 0564 0564 0024 0564 0564 0564 0564 0564 0564 0564 0564 0564 0564 0564 0564 0564 0564 0564 0564 0564 0564 0564 0564 0564 0564 0564 0564 0564 0564 0564 0564 0564 0564 0564 0564 0564 0564 0564 0564 0564 0564 0564 0564 0564 0564 0564 0564 0564 0564 0564 0564 0564 0564 0564 0564 0564 0564 0564 0564 0564 0001 0001 0001 0001 0001 0001 0001 0001 0564 0564 0564 0001 0001 0001 0024 0564 0564 0564 0564 0564 0564 0564 0564 0564 0564 0564 0564 0564 0564 0024 0564 0564 0564 0564 0564 0564 0564 0564 0564 0564 0564 0001 0001 0001 0564 0564 0564 0564 0001 0024 0024 0001 0564 0564 0564 0564 0564 0564 0564 0564 0564 0564 0564 0564 0564 0564 0564 0564 0564 0564 0564 0564 0564 0564 0564 0564 0564 0564 0564 0564 0564 0564 0564 0564 0564 0564 0564 0564 0564 0564 0564 0564 0564 0564 0564 0564 0564 0564 0564 0564 0564 0564 0564 0564 0564 0564 0564 0564 0028 0028 0564 0564 0564 0564 0564 0564 0564 0564 0286 0564 0564 0564 0564 0564 0564 0564 0564 0564 0564 0564 0564 0564
0564 0564 0564 0564 0564 0564 0564 0564 0564 0564 0564 0564 0564 0564 0564 0564 0564 0564 0564 0564 0564 0564 0564 0564 0564 0564 0564 0564 0564 0564 0564 0564 0564 0564 0564 0564 0564 0564 0564 0564 0564 0564 0564 0564 0564 0564 0564 0564 0564 0564 0564 0564 0564 0564 0564 0564 0564 0564 0564 0564 0564 0564 0564 0564 0564 0564 0564 0564 0564 0564 0564 0564 0564 0564 0564 0564 0564 0564 0564 0564 0564 0564 0564 0564 0564 0564 0564 0564 0564 0564 0564 0564 0564 0564 0564 0564 0564 0564 0564 0564 0564 0564 0564 0564 0564 0564 0564 0564 0564 0564 0564 0564 0564 0564 0564 0564 0564 0564 0564 0564 0564 0564 0564 0564 0564 0564 0564 0564 0564 0564 0564 0564 0564 0564 0564 0564 0564 0564 0564 0564 0564 0564 0564 0564 0564 0564 0564 0564 0564 0564 0564 0564 0564 0564 0564 0564 0564 0564 0564 0564 0564 0564 0564 0564 0564 0564 0564 0564 0564 0564 0564 0564 0564 0564 0564 0564 0564 0564 0564 0564 0564 0564 0564 0564 0564 0564 0028 0028 0028 0564 0564 0564 0564 0564 0564 0564 0564 0286 0564 0564 0564 0564 0564 0564 0564 0564 0564 0564 0564 0564 0564
0564 0564 0564 0564 0564 0564 0564 0564 0564 0564 0564 0564 0564 0564 0564 0564 0564 0564 0564 0564 0564 0564 0564 0564 0564 0564 0564 0564 0564 0564 0564 0564 0564 0564 0564 0564 0564 0564 0564 0564 0564 0564 0564 0564 0564 0564 0564 0564 0564 0564 0564 0564 0564 0564 0564 0564 0564 0564 0564 0564 0564 0564 0564 0564 0564 0564 0564 0564 0564 0564 0564 0564 0564 0564 0564 0564 0564 0564 0564 0564 0564 0564 0564 0564 0564 0564 0564 0564 0564 0564 0564 0564 0564 0564 0564 0564 0564 0564 0564 0564 0564 0564 0564 0564 0564 0564 0564 0564 0564 0564 0564 0564 0564 0564 0564 0564 0564 0564 0564 0564 0564 0564 0564 0564 0564 0564 0564 0564 0564 0564 0564 0564 0564 0564 0564 0564 0564 0564 0564 0564 0564 0564 0564 0564 0564 0564 0564 0564 0564 0564 0564 0564 0564 0564 0564 0564 0564 0564 0564 0564 0564 0564 0564 0564 0564 0564 0564 0564 0564 0564 0564 0564 0564 0564 0564 0564 0564 0564 0564 0564 0564 0564 0564 0564 0564 0028 0028 0028 0028 0564 0564 0564 0564 0564 0564 0564 0564 0286 0564 0564 0564 0564 0564 0564 0564 0564 0564 0564 0564 0564 0564
0564 0564 0564 0564 0564 0564 0564 0564 0564 0564 0564 0564 0564 0564 0564 0564 0564 0564 0564 0564 0564 0564 0564 0564 0564 0564 0564 0564 0564 0564 0564 0564 0564 0564 0564 0564 0564 0564 0564 0564 0564 0564 0564 0564 0564 0564 0564 0564 0564 0564 0564 0564 0564 0564 0564 0564 0564 0564 0564 0564 0564 0564 0564 0564 0564 0564 0564 0564 0564 0564 0564 0564 0564 0564 0564 0564 0564 0564 0564 0564 0564 0564 0564 0564 0564 0564 0564 0564 0564 0564 0564 0564 0564 0564 0564 0564 0564 0564 0564 0564 0564 0564 0564 0564 0564 0564 0564 0564 0564 0564 0564 0564 0564 0564 0564 0564 0564 0564 0564 0564 0564 0564 0564 0564 0564 0564 0564 0564 0564 0564 0564 0564 0564 0564 0564 0564 0564 0564 0564 0564 0564 0564 0564 0564 0564 0564 0564 0564 0564 0564 0564 0564 0564 0564 0564 0564 0564 0564 0564 0564 0564 0564 0564 0564 0564 0564 0564 0564 0564 0564 0564 0564 0564 0564 0564 0564 0564 0564 0564 0564 0564 0564 0564 0564 0028 0028 0028 0028 0028 0564 0564 0564 0564 0564 0564 0564 0564 0286 0564 0564 0564 0564 0011 0011 0011 0564 0564 0564 0564 0564 0564
0564 0564 0564 0564 0564 0564 0564 0564 0564 0564 0564 0564 0564 0564 0564 0024 0564 0564 0564 0001 0024 0001 0024 0001 0564 0564 0564 0564 0564 0564 0564 0564 0564 0564 0564 0564 0564 0564 0564 0564 0564 0564 0564 0564 0564 0244 0245 0564 0564 0564 0564 0564 0564 0564 0564 0564 0244 0245 0564 0564 0564 0564 0564 0564 0564 0564 0564 0564 0564 0564 0564 0564 0564 0564 0564 0564 0001 0024 0001 0564 0564 0564 0564 0564 0564 0564 0564 0564 0564 0564 0564 0564 0564 0001 0564 0564 0564 0564 0564 0001 0001 0564 0564 0564 0564 0024 0564 0564 0024 0564 0564 0024 0564 0564 0564 0564 0564 0001 0564 0564 0564 0564 0564 0564 0564 0564 0564 0564 0001 0001 0564 0564 0564 0564 0564 0564 0028 0564 0564 0028 0564 0564 0564 0564 0564 0564 0564 0564 0564 0564 0028 0028 0564 0564 0028 0564 0564 0564 0564 0564 0564 0564 0564 0564 0564 0564 0564 0001 0001 0024 0001 0564 0564 0564 0564 0564 0564 0564 0564 0564 0564 0564 0564 0028 0028 0028 0028 0028 0028 0564 0564 0564 0564 0564 0564 0564 0564 0286 0564 0564 0564 0564 0012 0002 0014 0564 0564 0564 0564 0564 0564
0564 0564 0253 0564 0564 0564 0564 0564 0564 0564 0564 0564 0564 0564 0564 0564 0564 0564 0564 0564 0564 0564 0564 0564 0564 0564 0564 0564 0564 0564 0564 0564 0564 0564 0564 0564 0564 0244 0245 0564 0564 0564 0564 0564 0564 0270 0271 0564 0564 0253 0564 0564 0564 0564 0564 0564 0270 0271 0564 0564 0564 0564 0564 0564 0564 0564 0564 0564 0564 0564 0564 0564 0564 0564 0564 0564 0564 0564 0564 0564 0564 0564 0564 0564 0564 0564 0564 0564 0564 0564 0564 0564 0564 0564 0564 0564 0564 0253 0564 0564 0564 0564 0564 0564 0564 0564 0564 0564 0564 0564 0564 0564 0564 0564 0564 0564 0564 0564 0564 0564 0564 0564 0564 0564 0564 0564 0564 0564 0564 0564 0564 0564 0564 0564 0564 0028 0028 0564 0564 0028 0028 0564 0564 0564 0564 0253 0564 0564 0564 0028 0028 0028 0564 0564 0028 0028 0564 0564 0564 0564 0564 0564 0564 0564 0564 0564 0564 0564 0564 0564 0564 0564 0564 0564 0564 0564 0564 0564 0564 0564 0564 0564 0028 0028 0028 0028 0028 0028 0028 0564 0564 0564 0564 0253 0564 0564 0564 0286 0564 0564 0564 0011 0038 0038 0038 0011 0564 0564 0564 0564 0564
0564 0252 0278 0254 0564 0564 0564 0564 0564 0564 0564 0564 0564 0564 0564 0564 0253 0564 0564 0564 0564 0564 0564 0564 0564 0564 0564 0244 0245 0564 0564 0564 0564 0564 0564 0564 0564 0270 0271 0564 0564 0564 0564 0564 0564 0270 0271 0564 0252 0278 0254 0564 0564 0564 0564 0564 0270 0271 0564 0564 0564 0564 0564 0564 0253 0564 0564 0564 0564 0564 0564 0564 0564 0564 0564 0564 0564 0564 0564 0564 0564 0564 0564 0564 0564 0564 0564 0564 0564 0564 0564 0564 0564 0564 0564 0564 0252 0278 0254 0564 0564 0564 0564 0564 0564 0564 0564 0564 0564 0564 0564 0564 0253 0564 0564 0564 0564 0564 0564 0564 0564 0564 0564 0564 0564 0564 0564 0564 0564 0564 0564 0564 0564 0564 0028 0028 0028 0564 0564 0028 0028 0028 0564 0564 0252 0278 0254 0564 0028 0028 0028 0028 0564 0564 0028 0028 0028 0564 0564 0564 0253 0564 0244 0245 0564 0564 0564 0564 0564 0564 0564 0564 0564 0564 0564 0564 0564 0564 0244 0245 0564 0028 0028 0028 0028 0028 0028 0028 0028 0564 0564 0564 0252 0278 0254 0564 0564 0286 0564 0564 0564 0002 0002 0039 0002 0002 0564 0564 0253 0564 0564
0252 0278 0279 0278 0254 0564 0564 0564 0564 0564 0564 0281 0282 0282 0283 0252 0278 0254 0564 0564 0564 0564 0281 0282 0283 0564 0564 0270 0271 0564 0564 0564 0564 0564 0564 0564 0564 0270 0271 0564 0281 0282 0282 0283 0564 0270 0271 0252 0278 0279 0278 0254 0564 0564 0564 0564 0270 0271 0281 0282 0282 0282 0283 0252 0278 0254 0564 0564 0564 0564 0281 0282 0283 0564 0564 0564 0564 0564 0564 0564 0564 0564 0564 0564 0564 0564 0564 0564 0281 0282 0282 0283 0564 0564 0564 0252 0278 0279 0278 0254 0564 0564 0564 0564 0564 0564 0281 0282 0282 0282 0283 0252 0278 0254 0564 0564 0564 0564 0281 0282 0283 0564 0564 0564 0564 0564 0564 0564 0564 0564 0564 0564 0564 0028 0028 0028 0028 0282 0282 0028 0028 0028 0028 0252 0278 0279 0278 0028 0028 0028 0028 0028 0564 0564 0028 0028 0028 0028 0283 0252 0278 0254 0270 0271 0564 0564 0281 0282 0283 0564 0564 0564 0564 0564 0564 0564 0564 0564 0270 0271 0028 0028 0028 0028 0028 0028 0028 0028 0028 0564 0564 0252 0278 0279 0278 0254 0564 0028 0564 0564 0564 0002 0002 0040 0002 0002 0283 0252 0278 0254 0564
0000 0000 0000 0000 0000 0000 0000 0000 0000 0000 0000 0000 0000 0000 0000 0000 0000 0000 0000 0000 0000 0000 0000 0000 0000 0000 0000 0000 0000 0000 0000 0000 0000 0000 0000 0000 0000 0000 0000 0000 0000 0000 0000 0000 0000 0000 0000 0000 0000 0000 0000 0000 0000 0000 0000 0000 0000 0000 0000 0000 0000 0000 0000 0000 0000 0000 0000 0000 0564 0564 0000 0000 0000 0000 0000 0000 0000 0000 0000 0000 0000 0000 0000 0000 0000 0564 0564 0564 0000 0000 0000 0000 0000 0000 0000 0000 0000 0000 0000 0000 0000 0000 0000 0000 0000 0000 0000 0000 0000 0000 0000 0000 0000 0000 0000 0000 0000 0000 0000 0000 0000 0000 0000 0000 0000 0000 0000 0000 0000 0000 0000 0000 0000 0000 0000 0000 0000 0000 0000 0000 0000 0000 0000 0000 0000 0000 0000 0000 0000 0000 0000 0000 0564 0564 0000 0000 0000 0000 0000 0000 0000 0000 0000 0000 0000 0000 0000 0000 0000 0000 0000 0000 0000 0000 0000 0000 0000 0000 0000 0000 0000 0000 0000 0000 0000 0000 0000 0000 0000 0000 0000 0000 0000 0000 0000 0000 0000 0000 0000 0000 0000 0000 0000 0000 0000 0000 0000 0000 0000 0000 0000
0000 0000 0000 0000 0000 0000 0000 0000 0000 0000 0000 0000 0000 0000 0000 0000 0000 0000 0000 0000 0000 0000 0000 0000 0000 0000 0000 0000 0000 0000 0000 0000 0000 0000 0000 0000 0000 0000 0000 0000 0000 0000 0000 0000 0000 0000 0000 0000 0000 0000 0000 0000 0000 0000 0000 0000 0000 0000 0000 0000 0000 0000 0000 0000 0000 0000 0000 0000 0564 0564 0000 0000 0000 0000 0000 0000 0000 0000 0000 0000 0000 0000 0000 0000 0000 0564 0564 0564 0000 0000 0000 0000 0000 0000 0000 0000 0000 0000 0000 0000 0000 0000 0000 0000 0000 0000 0000 0000 0000 0000 0000 0000 0000 0000 0000 0000 0000 0000 0000 0000 0000 0000 0000 0000 0000 0000 0000 0000 0000 0000 0000 0000 0000 0000 0000 0000 0000 0000 0000 0000 0000 0000 0000 0000 0000 0000 0000 0000 0000 0000 0000 0000 0564 0564 0000 0000 0000 0000 0000 0000 0000 0000 0000 0000 0000 0000 0000 0000 0000 0000 0000 0000 0000 0000 0000 0000 0000 0000 0000 0000 0000 0000 0000 0000 0000 0000 0000 0000 0000 0000 0000 0000 0000 0000 0000 0000 0000 0000 0000 0000 0000 0000 0000 0000 0000 0000 0000 0000 0000 0000 0000
