000000000000000000000000000000000
000000000000000000000000000000000
000000000000000000CLS000000000000
000000000000000000UDT00000CLLLS00
00000000000000000000000000UDDDT00
0000000000000000000000?0000000000
000000000000000000000000000000000
000000000000000000000000000000000
000000000000000000000000000000000
000000000000000?000B?B?B000000000
00_000000000000000000000000000000
0/M\000000000000_0000000000PI0000
/MGM\000000)YY(/M\0000)Y(00ER0000
111111111111111111111111111111111
111111111111111111111111111111111