33 15
0  0
0564 0564 0564 0564 0564 0564 0564 0564 0564 0564 0564 0564 0564 0564 0564 0564 0564 0564 0564 0564 0564 0564 0564 0564 0564 0564 0564 0564 0564 0564 0564 0564 0564
0564 0564 0564 0564 0564 0564 0564 0564 0564 0564 0564 0564 0564 0564 0564 0564 0564 0564 0564 0564 0564 0564 0564 0564 0564 0564 0564 0564 0564 0564 0564 0564 0564
0564 0564 0564 0564 0564 0564 0564 0564 0564 0564 0564 0564 0564 0564 0564 0564 0564 0564 0550 0551 0552 0564 0564 0564 0564 0564 0564 0564 0564 0564 0564 0564 0564
0564 0564 0564 0564 0564 0564 0564 0564 0564 0564 0564 0564 0564 0564 0564 0564 0564 0564 0561 0562 0563 0564 0564 0564 0564 0564 0550 0551 0551 0551 0552 0564 0564
0564 0564 0564 0564 0564 0564 0564 0564 0564 0564 0564 0564 0564 0564 0564 0564 0564 0564 0564 0564 0564 0564 0564 0564 0564 0564 0561 0562 0562 0562 0563 0564 0564
0564 0564 0564 0564 0564 0564 0564 0564 0564 0564 0564 0564 0564 0564 0564 0564 0564 0564 0564 0564 0564 0024 0564 0564 0564 0564 0564 0564 0564 0564 0564 0564 0564
0564 0564 0564 0564 0564 0564 0564 0564 0564 0564 0564 0564 0564 0564 0564 0564 0564 0564 0564 0564 0564 0564 0564 0564 0564 0564 0564 0564 0564 0564 0564 0564 0564
0564 0564 0564 0564 0564 0564 0564 0564 0564 0564 0564 0564 0564 0564 0564 0564 0564 0564 0564 0564 0564 0564 0564 0564 0564 0564 0564 0564 0564 0564 0564 0564 0564
0564 0564 0564 0564 0564 0564 0564 0564 0564 0564 0564 0564 0564 0564 0564 0564 0564 0564 0564 0564 0564 0564 0564 0564 0564 0564 0564 0564 0564 0564 0564 0564 0564
0564 0564 0564 0564 0564 0564 0564 0564 0564 0564 0564 0564 0564 0564 0564 0024 0564 0564 0564 0001 0024 0001 0024 0001 0564 0564 0564 0564 0564 0564 0564 0564 0564 
0564 0564 0253 0564 0564 0564 0564 0564 0564 0564 0564 0564 0564 0564 0564 0564 0564 0564 0564 0564 0564 0564 0564 0564 0564 0564 0564 0564 0564 0564 0564 0564 0564
0564 0252 0278 0254 0564 0564 0564 0564 0564 0564 0564 0564 0564 0564 0564 0564 0253 0564 0564 0564 0564 0564 0564 0564 0564 0564 0564 0244 0245 0564 0564 0564 0564
0252 0278 0279 0278 0254 0564 0564 0564 0564 0564 0564 0281 0282 0282 0283 0252 0278 0254 0564 0564 0564 0564 0281 0282 0283 0564 0564 0270 0271 0564 0564 0564 0564
0000 0000 0000 0000 0000 0000 0000 0000 0000 0000 0000 0000 0000 0000 0000 0000 0000 0000 0000 0000 0000 0000 0000 0000 0000 0000 0000 0000 0000 0000 0000 0000 0000
0000 0000 0000 0000 0000 0000 0000 0000 0000 0000 0000 0000 0000 0000 0000 0000 0000 0000 0000 0000 0000 0000 0000 0000 0000 0000 0000 0000 0000 0000 0000 0000 0000