1 4
162 15
128 352
Bowser'sCastle
0152 0570 0570 0570 0570 0570 0570 0570 0570 0570 0570 0570 0570 0570 0570 0570 0570 0570 0570 0570 0570 0570 0570 0570 0570 0570 0570 0570 0570 0570 0570 0570 0570 0570 0570 0570 0570 0570 0570 0570 0570 0570 0570 0570 0570 0570 0570 0570 0570 0570 0570 0570 0570 0570 0570 0570 0570 0570 0570 0570 0570 0570 0570 0570 0570 0570 0570 0570 0570 0570 0570 0570 0570 0570 0570 0570 0570 0570 0570 0570 0570 0570 0570 0570 0570 0570 0570 0570 0570 0570 0570 0570 0570 0570 0570 0570 0570 0570 0570 0570 0570 0570 0570 0570 0570 0570 0570 0570 0570 0570 0570 0570 0570 0570 0570 0570 0570 0570 0570 0570 0570 0570 0570 0570 0570 0570 0570 0570 0570 0570 0570 0570 0570 0570 0570 0570 0570 0570 0570 0570 0570 0570 0570 0570 0570 0570 0570 0570 0570 0570 0570 0570 0570 0570 0570 0570 0570 0570 0570 0570 0570 0152
0152 0570 0570 0570 0570 0570 0570 0570 0570 0570 0570 0570 0570 0570 0570 0570 0570 0570 0570 0570 0570 0570 0570 0570 0570 0570 0570 0570 0570 0570 0570 0570 0570 0570 0570 0570 0570 0570 0570 0570 0570 0570 0570 0570 0570 0570 0570 0570 0570 0570 0570 0570 0570 0570 0570 0570 0570 0570 0570 0570 0570 0570 0570 0570 0570 0570 0570 0570 0570 0570 0570 0570 0570 0570 0570 0570 0570 0570 0570 0570 0570 0570 0570 0570 0570 0570 0570 0570 0570 0570 0570 0570 0570 0570 0570 0570 0570 0570 0570 0570 0570 0570 0570 0570 0570 0570 0570 0570 0570 0570 0570 0570 0570 0570 0570 0570 0570 0570 0570 0570 0570 0570 0570 0570 0570 0570 0570 0570 0570 0570 0570 0570 0570 0570 0570 0570 0570 0570 0570 0570 0570 0570 0570 0570 0570 0570 0570 0570 0570 0570 0570 0570 0570 0570 0570 0570 0570 0570 0570 0570 0570 0152
0152 0152 0152 0152 0152 0152 0152 0152 0152 0152 0152 0152 0152 0152 0152 0152 0152 0152 0152 0152 0152 0152 0152 0152 0152 0152 0152 0152 0152 0152 0152 0152 0152 0152 0152 0152 0152 0152 0152 0152 0152 0152 0152 0152 0152 0152 0152 0152 0152 0152 0152 0152 0152 0152 0152 0152 0152 0152 0152 0152 0152 0152 0152 0152 0152 0152 0152 0152 0152 0152 0152 0152 0152 0152 0152 0152 0152 0152 0152 0152 0152 0152 0152 0152 0152 0152 0152 0152 0152 0152 0152 0152 0152 0152 0152 0152 0152 0152 0152 0152 0152 0152 0152 0152 0152 0152 0152 0152 0152 0152 0152 0152 0152 0152 0152 0152 0152 0152 0152 0152 0152 0152 0152 0152 0152 0152 0152 0152 0152 0152 0152 0152 0152 0152 0152 0152 0152 0152 0152 0152 0152 0152 0152 0152 0152 0152 0152 0152 0152 0152 0152 0152 0152 0152 0152 0152 0152 0152 0152 0152 0152 0152
0152 0152 0152 0152 0152 0152 0152 0152 0152 0152 0152 0152 0152 0152 0152 0152 0152 0152 0152 0152 0152 0152 0152 0152 0152 0570 0570 0570 0570 0570 0570 0570 0570 0570 0570 0570 0570 0570 0152 0152 0152 0152 0152 0152 0152 0152 0152 0152 0152 0152 0152 0152 0152 0152 0152 0152 0152 0152 0152 0152 0152 0152 0152 0152 0152 0152 0152 0152 0152 0152 0152 0152 0152 0570 0570 0570 0570 0570 0570 0570 0570 0152 0570 0570 0570 0570 0570 0570 0570 0152 0570 0570 0570 0570 0570 0570 0570 0570 0152 0152 0152 0152 0152 0152 0152 0570 0570 0570 0570 0570 0570 0570 0570 0570 0570 0570 0570 0570 0570 0570 0570 0570 0570 0570 0152 0152 0152 0152 0152 0570 0570 0570 0570 0570 0570 0570 0570 0570 0570 0570 0570 0570 0570 0152 0152 0570 0570 0570 0570 0570 0570 0570 0570 0570 0570 0570 0570 0570 0570 0570 0570 0152
0152 0152 0152 0152 0152 0152 0152 0152 0152 0152 0152 0152 0152 0152 0152 0152 0152 0152 0152 0152 0152 0152 0152 0152 0152 0570 0570 0570 0570 0570 0570 0570 0570 0570 0570 0570 0570 0570 0152 0152 0152 0152 0152 0152 0152 0152 0152 0152 0152 0152 0152 0152 0152 0152 0152 0152 0152 0152 0152 0152 0152 0152 0152 0152 0152 0152 0152 0152 0152 0152 0152 0152 0152 0570 0570 0570 0570 0570 0570 0570 0570 0149 0570 0570 0570 0570 0570 0570 0570 0149 0570 0570 0570 0570 0570 0570 0570 0570 0152 0152 0152 0152 0152 0152 0152 0570 0570 0570 0570 0570 0570 0570 0570 0570 0570 0570 0570 0570 0570 0570 0570 0570 0570 0570 0152 0152 0152 0152 0152 0570 0570 0570 0570 0570 0570 0570 0570 0570 0570 0570 0570 0570 0570 0152 0152 0570 0570 0570 0570 0570 0570 0570 0570 0570 0570 0570 0570 0570 0570 0570 0570 0152
0152 0570 0570 0570 0570 0570 0570 0570 0570 0570 0570 0570 0570 0570 0570 0570 0570 0570 0570 0570 0570 0570 0570 0570 0149 0570 0570 0570 0570 0570 0570 0570 0570 0570 0570 0570 0570 0570 0152 0152 0152 0152 0152 0152 0152 0152 0152 0152 0152 0152 0152 0152 0152 0152 0152 0152 0152 0152 0152 0152 0152 0152 0152 0152 0152 0152 0152 0152 0152 0152 0152 0152 0152 0570 0570 0570 0570 0570 0570 0570 0570 0570 0570 0570 0570 0570 0570 0570 0570 0570 0570 0570 0570 0570 0570 0570 0570 0570 0570 0570 0570 0570 0570 0570 0570 0570 0570 0570 0570 0570 0570 0570 0570 0570 0570 0570 0570 0570 0570 0570 0570 0570 0570 0570 0570 0570 0570 0570 0570 0570 0570 0570 0570 0570 0570 0570 0570 0570 0570 0570 0570 0570 0570 0152 0152 0570 0570 0570 0570 0570 0570 0570 0570 0570 0570 0570 0570 0570 0570 0570 0570 0152
0152 0570 0570 0570 0570 0570 0570 0570 0570 0570 0570 0570 0570 0570 0570 0570 0570 0570 0570 0570 0570 0570 0570 0570 0570 0570 0570 0570 0570 0570 0570 0146 0570 0570 0570 0570 0570 0570 0149 0570 0570 0570 0570 0570 0570 0570 0570 0570 0570 0570 0149 0570 0570 0570 0570 0570 0570 0570 0570 0570 0570 0149 0570 0570 0570 0570 0570 0570 0149 0570 0570 0570 0570 0570 0570 0570 0570 0570 0570 0570 0570 0570 0570 0570 0570 0570 0570 0570 0570 0570 0570 0570 0570 0570 0570 0570 0570 0570 0570 0570 0570 0570 0570 0570 0570 0570 0570 0570 0570 0570 0570 0570 0570 0570 0570 0570 0570 0570 0570 0570 0570 0570 0570 0570 0570 0570 0570 0570 0570 0570 0570 0570 0570 0570 0570 0570 0570 0570 0570 0570 0570 0570 0570 0570 0570 0570 0570 0570 0570 0570 0570 0570 0570 0570 0570 0570 0570 0570 0570 0570 0570 0152
0152 0152 0152 0152 0153 0570 0570 0570 0570 0570 0570 0570 0570 0570 0570 0570 0570 0570 0570 0570 0570 0570 0570 0570 0570 0570 0570 0570 0570 0570 0570 0570 0570 0570 0570 0570 0570 0570 0570 0570 0570 0570 0570 0570 0570 0570 0570 0570 0570 0570 0570 0570 0570 0570 0570 0570 0570 0570 0570 0570 0570 0570 0570 0570 0570 0570 0570 0570 0570 0570 0570 0570 0570 0570 0570 0570 0570 0570 0570 0570 0570 0570 0570 0570 0570 0570 0570 0570 0570 0570 0570 0570 0570 0570 0570 0570 0570 0570 0570 0570 0570 0570 0570 0570 0570 0570 0570 0570 0570 0570 0570 0570 0570 0570 0570 0570 0570 0570 0570 0570 0570 0570 0570 0570 0570 0570 0570 0570 0570 0570 0570 0570 0570 0570 0570 0570 0570 0570 0570 0570 0570 0570 0570 0570 0570 0570 0570 0570 0570 0570 0570 0570 0570 0570 0570 0570 0570 0570 0570 0570 0570 0152
0152 0152 0152 0152 0152 0153 0570 0570 0570 0570 0570 0570 0570 0570 0570 0570 0570 0570 0570 0570 0570 0570 0570 0570 0570 0570 0570 0570 0570 0570 0570 0570 0570 0570 0570 0570 0570 0570 0570 0570 0570 0570 0570 0570 0570 0570 0570 0570 0570 0570 0570 0570 0570 0570 0570 0570 0570 0570 0570 0570 0570 0570 0570 0570 0570 0570 0570 0570 0570 0570 0570 0570 0570 0570 0570 0570 0570 0570 0570 0570 0570 0570 0570 0570 0570 0570 0570 0570 0570 0570 0570 0570 0570 0570 0570 0570 0570 0570 0570 0570 0570 0570 0570 0570 0570 0570 0570 0570 0570 0570 0570 0570 0570 0570 0570 0570 0570 0570 0570 0570 0570 0570 0570 0570 0570 0570 0570 0570 0570 0570 0570 0570 0570 0570 0570 0570 0570 0570 0570 0570 0570 0570 0177 0570 0570 0570 0570 0570 0570 0570 0570 0570 0570 0570 0570 0570 0570 0570 0570 0570 0570 0152
0152 0152 0152 0152 0152 0152 0153 0570 0570 0570 0570 0570 0570 0570 0570 0570 0570 0570 0570 0570 0570 0570 0570 0570 0570 0570 0570 0570 0570 0570 0570 0570 0570 0570 0570 0570 0152 0152 0152 0152 0152 0152 0152 0152 0152 0152 0152 0152 0152 0152 0152 0152 0152 0152 0152 0152 0152 0152 0152 0152 0152 0152 0152 0152 0152 0152 0152 0152 0152 0152 0152 0152 0152 0570 0570 0570 0570 0149 0570 0570 0570 0570 0570 0570 0570 0149 0570 0570 0570 0570 0570 0570 0570 0149 0570 0570 0570 0570 0570 0570 0570 0570 0570 0570 0570 0570 0570 0570 0570 0570 0570 0570 0570 0570 0570 0570 0570 0570 0570 0570 0570 0570 0570 0570 0570 0570 0570 0570 0570 0570 0570 0570 0570 0570 0570 0570 0570 0570 0570 0570 0570 0460 0152 0152 0152 0570 0570 0570 0570 0570 0570 0570 0570 0570 0570 0570 0570 0570 0570 0570 0570 0152
0152 0152 0152 0152 0152 0152 0152 0152 0152 0152 0152 0152 0152 0152 0153 0570 0152 0152 0152 0152 0152 0152 0152 0152 0152 0152 0152 0570 0570 0570 0152 0149 0152 0570 0570 0570 0152 0152 0152 0152 0152 0152 0152 0152 0152 0152 0152 0152 0152 0152 0152 0152 0152 0152 0152 0152 0152 0152 0152 0152 0152 0152 0152 0152 0152 0152 0152 0152 0152 0152 0152 0152 0152 0152 0152 0152 0152 0152 0152 0152 0152 0152 0152 0152 0152 0152 0152 0152 0152 0152 0152 0152 0152 0152 0152 0152 0152 0152 0152 0152 0152 0152 0152 0152 0152 0570 0570 0570 0570 0570 0570 0570 0570 0570 0570 0570 0570 0152 0152 0152 0152 0570 0570 0570 0152 0152 0152 0152 0152 0594 0594 0594 0594 0594 0594 0594 0594 0594 0594 0594 0594 0594 0152 0152 0152 0570 0570 0570 0570 0570 0570 0570 0570 0570 0570 0570 0570 0570 0570 0570 0570 0152
0152 0152 0152 0152 0152 0152 0152 0152 0152 0152 0152 0152 0152 0152 0153 0570 0152 0152 0152 0152 0152 0152 0152 0152 0152 0152 0152 0570 0570 0570 0152 0152 0152 0570 0570 0570 0152 0152 0152 0152 0152 0152 0152 0152 0152 0152 0152 0152 0152 0152 0152 0152 0152 0152 0152 0152 0152 0152 0152 0152 0152 0152 0152 0152 0152 0152 0152 0152 0152 0152 0152 0152 0152 0152 0152 0152 0152 0152 0152 0152 0152 0152 0152 0152 0152 0152 0152 0152 0152 0152 0152 0152 0152 0152 0152 0152 0152 0152 0152 0152 0152 0152 0152 0152 0152 0570 0570 0570 0570 0570 0570 0570 0570 0570 0570 0570 0570 0152 0152 0152 0152 0570 0570 0570 0152 0152 0152 0152 0152 0570 0570 0570 0570 0570 0570 0570 0570 0570 0570 0570 0570 0570 0152 0152 0152 0570 0570 0570 0570 0570 0570 0570 0570 0570 0570 0570 0570 0570 0570 0570 0570 0152
0152 0152 0152 0152 0152 0152 0152 0152 0152 0152 0152 0152 0152 0152 0593 0593 0152 0152 0152 0152 0152 0152 0152 0152 0152 0152 0152 0570 0570 0570 0152 0152 0152 0570 0570 0570 0152 0152 0152 0152 0152 0152 0152 0152 0152 0152 0152 0152 0152 0152 0152 0152 0152 0152 0152 0152 0152 0152 0152 0152 0152 0152 0152 0152 0152 0152 0152 0152 0152 0152 0152 0152 0152 0152 0152 0152 0152 0152 0152 0152 0152 0152 0152 0152 0152 0152 0152 0152 0152 0152 0152 0152 0152 0152 0152 0152 0152 0152 0152 0152 0152 0152 0152 0152 0152 0570 0570 0570 0570 0570 0570 0570 0570 0570 0570 0570 0570 0152 0152 0152 0152 0570 0570 0570 0152 0152 0152 0152 0152 0570 0570 0570 0570 0570 0570 0570 0570 0570 0570 0570 0570 0570 0152 0152 0152 0570 0570 0570 0570 0570 0570 0570 0570 0570 0570 0570 0570 0570 0570 0570 0570 0152
0152 0152 0152 0152 0152 0152 0152 0152 0152 0152 0152 0152 0152 0152 0604 0604 0152 0152 0152 0152 0152 0152 0152 0152 0152 0152 0152 0593 0593 0593 0152 0152 0152 0593 0593 0593 0152 0152 0152 0152 0152 0152 0152 0152 0152 0152 0152 0152 0152 0152 0152 0152 0152 0152 0152 0152 0152 0152 0152 0152 0152 0152 0152 0152 0152 0152 0152 0152 0152 0152 0152 0152 0152 0152 0152 0152 0152 0152 0152 0152 0152 0152 0152 0152 0152 0152 0152 0152 0152 0152 0152 0152 0152 0152 0152 0152 0152 0152 0152 0152 0152 0152 0152 0152 0152 0152 0152 0152 0152 0152 0152 0152 0152 0152 0152 0152 0152 0152 0152 0152 0152 0152 0152 0152 0152 0152 0152 0152 0152 0593 0593 0593 0593 0593 0593 0593 0593 0593 0593 0593 0593 0593 0152 0152 0152 0152 0152 0152 0152 0152 0152 0152 0152 0152 0152 0152 0152 0152 0152 0152 0152 0152
0152 0152 0152 0152 0152 0152 0152 0152 0152 0152 0152 0152 0152 0152 0604 0604 0152 0152 0152 0152 0152 0152 0152 0152 0152 0152 0152 0604 0604 0604 0152 0152 0152 0604 0604 0604 0152 0152 0152 0152 0152 0152 0152 0152 0152 0152 0152 0152 0152 0152 0152 0152 0152 0152 0152 0152 0152 0152 0152 0152 0152 0152 0152 0152 0152 0152 0152 0152 0152 0152 0152 0152 0152 0152 0152 0152 0152 0152 0152 0152 0152 0152 0152 0152 0152 0152 0152 0152 0152 0152 0152 0152 0152 0152 0152 0152 0152 0152 0152 0152 0152 0152 0152 0152 0152 0152 0152 0152 0152 0152 0152 0152 0152 0152 0152 0152 0152 0152 0152 0152 0152 0152 0152 0152 0152 0152 0152 0152 0152 0604 0604 0604 0604 0604 0604 0604 0604 0604 0604 0604 0604 0604 0152 0152 0152 0152 0152 0152 0152 0152 0152 0152 0152 0152 0152 0152 0152 0152 0152 0152 0152 0152