167 15
128 352
RunningAbout
0000 0569 0569 0569 0569 0569 0569 0569 0569 0569 0569 0569 0569 0569 0569 0569 0569 0569 0569 0569 0569 0569 0569 0569 0569 0569 0569 0569 0569 0569 0569 0569 0569 0569 0569 0569 0569 0569 0569 0569 0569 0569 0569 0569 0569 0569 0569 0569 0569 0569 0569 0569 0569 0569 0569 0569 0569 0569 0569 0569 0569 0569 0569 0569 0569 0569 0569 0569 0569 0569 0569 0569 0569 0569 0569 0569 0569 0569 0569 0569 0569 0569 0569 0569 0569 0569 0569 0569 0569 0569 0569 0569 0569 0569 0569 0569 0569 0569 0569 0569 0569 0569 0569 0569 0569 0569 0569 0569 0569 0569 0569 0569 0569 0569 0569 0569 0569 0569 0569 0569 0569 0569 0569 0569 0569 0569 0569 0569 0569 0569 0569 0569 0569 0569 0569 0569 0569 0569 0569 0569 0569 0569 0569 0569 0569 0569 0569 0569 0569 0569 0569 0569 0569 0569 0569 0569 0569 0569 0569 0569 0569 0569 0569 0569 0569 0569 0000
0000 0569 0569 0569 0569 0569 0569 0569 0569 0569 0569 0569 0569 0569 0569 0569 0569 0569 0569 0569 0569 0569 0569 0569 0569 0569 0569 0569 0569 0569 0569 0569 0569 0569 0569 0569 0569 0569 0569 0569 0569 0569 0569 0569 0569 0569 0569 0569 0569 0569 0569 0569 0569 0569 0569 0569 0569 0569 0569 0569 0569 0569 0569 0569 0569 0569 0569 0569 0569 0569 0569 0569 0569 0569 0569 0569 0569 0569 0569 0569 0569 0569 0569 0569 0569 0569 0569 0569 0569 0569 0569 0569 0569 0569 0569 0569 0569 0569 0569 0569 0569 0569 0569 0569 0569 0569 0569 0569 0569 0569 0569 0569 0569 0569 0569 0569 0569 0569 0569 0569 0569 0569 0569 0569 0569 0569 0569 0569 0569 0569 0569 0569 0569 0569 0569 0569 0569 0569 0569 0569 0569 0569 0569 0569 0569 0569 0569 0569 0569 0569 0569 0569 0569 0569 0569 0569 0569 0569 0569 0569 0569 0569 0569 0569 0569 0569 0000
0000 0569 0569 0569 0569 0569 0569 0569 0569 0569 0569 0569 0569 0569 0569 0569 0569 0569 0569 0550 0551 0551 0552 0569 0569 0569 0569 0569 0569 0569 0569 0569 0569 0569 0569 0569 0569 0569 0569 0569 0569 0569 0569 0569 0569 0569 0569 0569 0569 0569 0569 0569 0569 0569 0569 0569 0569 0569 0569 0569 0569 0569 0569 0569 0569 0569 0569 0550 0551 0551 0552 0569 0569 0569 0569 0569 0569 0569 0569 0569 0569 0569 0569 0569 0569 0569 0569 0569 0569 0569 0569 0569 0569 0569 0569 0569 0569 0569 0569 0569 0569 0569 0569 0569 0569 0569 0569 0569 0569 0569 0569 0569 0569 0569 0569 0550 0551 0551 0552 0569 0569 0569 0569 0569 0569 0569 0569 0569 0569 0569 0569 0569 0569 0569 0569 0569 0569 0569 0569 0569 0569 0569 0569 0569 0569 0569 0569 0569 0569 0569 0569 0569 0569 0225 0569 0569 0569 0569 0569 0569 0011 0011 0011 0569 0550 0551 0000
0000 0569 0569 0569 0550 0551 0551 0552 0569 0569 0569 0569 0569 0569 0569 0569 0569 0569 0569 0561 0562 0562 0563 0569 0569 0569 0569 0569 0569 0569 0569 0569 0569 0569 0569 0569 0569 0569 0569 0569 0569 0569 0569 0569 0569 0569 0569 0569 0569 0569 0569 0569 0550 0551 0551 0552 0569 0569 0569 0569 0569 0569 0569 0569 0569 0569 0569 0561 0562 0562 0563 0569 0569 0569 0569 0569 0569 0569 0569 0569 0569 0569 0569 0569 0569 0569 0569 0569 0569 0569 0569 0569 0569 0569 0569 0569 0569 0569 0569 0569 0550 0551 0551 0552 0569 0569 0569 0569 0569 0569 0569 0569 0569 0569 0569 0561 0562 0562 0563 0569 0569 0569 0569 0569 0569 0569 0569 0569 0569 0569 0569 0569 0569 0569 0569 0569 0569 0569 0569 0569 0569 0569 0569 0569 0569 0569 0569 0569 0550 0551 0551 0552 0288 0286 0569 0569 0569 0569 0569 0569 0012 0002 0014 0569 0561 0562 0000
0000 0569 0569 0569 0561 0562 0562 0563 0569 0569 0569 0569 0569 0569 0569 0569 0569 0569 0569 0569 0569 0569 0569 0569 0569 0569 0569 0569 0569 0569 0569 0569 0569 0569 0569 0569 0569 0569 0569 0569 0569 0249 0250 0250 0250 0250 0250 0251 0569 0569 0569 0569 0561 0562 0562 0563 0569 0569 0569 0569 0569 0569 0569 0569 0569 0569 0569 0569 0569 0569 0569 0569 0569 0569 0569 0569 0569 0569 0569 0569 0569 0569 0569 0569 0569 0569 0569 0569 0569 0569 0569 0569 0569 0569 0569 0569 0569 0569 0569 0569 0561 0562 0562 0563 0569 0569 0569 0569 0569 0569 0569 0569 0569 0569 0569 0569 0569 0569 0569 0569 0569 0569 0569 0569 0569 0569 0569 0569 0569 0569 0569 0569 0569 0569 0569 0569 0569 0569 0569 0569 0569 0569 0569 0569 0569 0569 0569 0569 0561 0562 0562 0563 0569 0286 0569 0569 0569 0569 0569 0011 0038 0038 0038 0011 0569 0569 0000
0000 0569 0569 0569 0569 0569 0569 0569 0569 0569 0569 0569 0569 0569 0569 0569 0569 0569 0569 0569 0569 0569 0569 0569 0569 0569 0569 0249 0250 0250 0250 0251 0569 0569 0569 0569 0569 0569 0569 0569 0569 0569 0033 0033 0033 0033 0033 0569 0569 0569 0569 0569 0569 0569 0569 0569 0569 0569 0569 0569 0569 0249 0250 0250 0251 0569 0569 0569 0569 0569 0569 0569 0569 0569 0569 0569 0569 0569 0569 0569 0569 0569 0569 0569 0569 0569 0569 0569 0569 0569 0569 0569 0569 0569 0569 0569 0569 0569 0569 0569 0569 0569 0569 0569 0569 0569 0569 0569 0569 0569 0569 0569 0569 0569 0569 0569 0569 0569 0569 0569 0569 0569 0569 0569 0569 0569 0569 0569 0569 0569 0569 0569 0569 0569 0569 0569 0569 0569 0569 0569 0569 0569 0569 0028 0028 0569 0569 0569 0569 0569 0569 0569 0569 0286 0569 0569 0569 0569 0569 0002 0002 0039 0002 0002 0569 0569 0000
0000 0569 0569 0569 0569 0569 0569 0569 0569 0569 0569 0569 0569 0569 0569 0569 0569 0569 0569 0569 0569 0569 0569 0569 0569 0569 0569 0569 0033 0033 0033 0569 0569 0569 0569 0569 0569 0569 0569 0550 0551 0552 0033 0033 0033 0033 0033 0569 0569 0569 0569 0569 0569 0569 0569 0569 0569 0569 0569 0569 0569 0569 0033 0033 0569 0569 0569 0569 0569 0569 0569 0569 0569 0569 0569 0569 0569 0249 0250 0250 0250 0250 0251 0569 0569 0569 0569 0550 0551 0552 0569 0569 0569 0569 0569 0569 0569 0569 0569 0569 0569 0569 0569 0569 0569 0569 0569 0569 0569 0569 0569 0569 0569 0569 0569 0569 0569 0569 0569 0569 0569 0569 0569 0569 0569 0569 0569 0569 0569 0569 0569 0569 0569 0569 0569 0550 0551 0552 0569 0569 0569 0569 0569 0028 0028 0569 0569 0569 0569 0569 0569 0569 0569 0286 0569 0569 0569 0569 0569 0002 0002 0040 0002 0002 0569 0569 0000
0000 0569 0569 0569 0569 0569 0569 0569 0569 0569 0550 0551 0552 0569 0569 0569 0569 0569 0569 0569 0569 0569 0569 0569 0569 0569 0569 0569 0033 0033 0033 0569 0569 0569 0569 0569 0550 0551 0552 0561 0562 0563 0033 0033 0033 0033 0033 0569 0569 0569 0569 0569 0569 0569 0569 0569 0569 0569 0550 0551 0552 0569 0033 0033 0569 0569 0569 0569 0569 0569 0569 0569 0569 0569 0569 0569 0569 0569 0033 0033 0033 0033 0569 0569 0550 0551 0552 0561 0562 0563 0569 0569 0569 0569 0569 0569 0569 0569 0569 0569 0569 0569 0569 0569 0569 0249 0250 0250 0250 0250 0250 0250 0251 0569 0569 0569 0569 0569 0569 0569 0569 0569 0569 0569 0569 0569 0569 0569 0569 0569 0569 0569 0550 0551 0552 0561 0562 0563 0569 0569 0569 0028 0028 0028 0028 0569 0569 0569 0569 0569 0569 0569 0569 0286 0569 0569 0569 0011 0011 0038 0038 0038 0038 0038 0011 0011 0000
0000 0569 0011 0011 0011 0569 0569 0569 0569 0569 0561 0562 0563 0569 0569 0569 0569 0569 0569 0569 0569 0569 0569 0569 0569 0569 0569 0569 0033 0033 0033 0569 0569 0569 0569 0569 0249 0250 0250 0250 0251 0569 0033 0033 0033 0033 0033 0569 0569 0569 0569 0569 0569 0569 0569 0569 0569 0569 0561 0562 0563 0569 0033 0033 0569 0569 0569 0569 0569 0569 0569 0569 0569 0569 0569 0569 0569 0569 0033 0033 0033 0033 0569 0569 0561 0562 0563 0569 0569 0569 0569 0569 0569 0569 0569 0569 0569 0569 0569 0569 0569 0569 0569 0569 0569 0569 0033 0033 0033 0033 0033 0033 0569 0569 0569 0569 0569 0569 0569 0569 0569 0569 0569 0569 0569 0569 0569 0569 0569 0569 0569 0569 0561 0562 0563 0569 0569 0569 0569 0569 0569 0028 0028 0028 0028 0569 0569 0569 0569 0569 0569 0569 0569 0286 0569 0569 0569 0002 0002 0002 0039 0002 0039 0002 0002 0002 0000
0000 0569 0012 0002 0014 0569 0569 0569 0569 0569 0569 0569 0569 0569 0569 0569 0569 0569 0569 0569 0569 0569 0569 0569 0569 0249 0250 0250 0250 0250 0250 0250 0251 0569 0569 0569 0569 0033 0033 0033 0569 0569 0033 0033 0033 0033 0033 0569 0569 0569 0569 0569 0569 0569 0569 0569 0569 0569 0569 0569 0569 0569 0033 0033 0569 0569 0569 0569 0569 0569 0569 0249 0250 0251 0569 0569 0569 0569 0033 0033 0033 0033 0569 0569 0569 0569 0569 0569 0569 0569 0569 0569 0569 0569 0569 0569 0569 0569 0569 0569 0569 0569 0569 0569 0569 0569 0033 0033 0033 0033 0033 0033 0569 0569 0569 0569 0569 0249 0250 0250 0251 0569 0569 0249 0250 0250 0251 0569 0569 0569 0569 0569 0569 0569 0569 0569 0569 0569 0569 0028 0028 0028 0028 0028 0028 0569 0569 0569 0569 0569 0569 0569 0569 0286 0569 0569 0569 0002 0002 0002 0040 0002 0040 0002 0002 0002 0000
0000 0011 0038 0038 0038 0011 0569 0569 0569 0569 0569 0569 0569 0569 0569 0569 0569 0569 0569 0569 0569 0569 0569 0569 0569 0569 0033 0033 0033 0033 0033 0033 0569 0569 0569 0569 0569 0033 0033 0033 0569 0569 0033 0033 0033 0033 0033 0569 0569 0569 0569 0569 0569 0569 0569 0569 0569 0569 0569 0569 0024 0569 0033 0033 0569 0569 0569 0569 0569 0569 0569 0569 0033 0569 0569 0569 0569 0569 0033 0033 0033 0033 0569 0569 0569 0569 0569 0569 0569 0569 0569 0569 0569 0569 0569 0569 0569 0569 0569 0569 0569 0569 0569 0569 0569 0569 0033 0033 0033 0033 0033 0033 0569 0569 0569 0569 0569 0569 0033 0033 0569 0569 0569 0569 0033 0033 0569 0569 0569 0569 0569 0569 0569 0569 0569 0569 0569 0569 0569 0028 0028 0028 0028 0028 0028 0569 0569 0569 0569 0569 0569 0569 0569 0286 0569 0569 0569 0002 0002 0002 0002 0002 0002 0002 0002 0002 0000
0000 0002 0002 0039 0002 0002 0569 0569 0569 0569 0569 0569 0569 0569 0569 0569 0569 0569 0569 0569 0569 0569 0569 0569 0569 0569 0033 0033 0033 0033 0033 0033 0569 0569 0569 0569 0569 0033 0033 0033 0569 0569 0033 0033 0033 0033 0033 0550 0551 0552 0569 0569 0569 0569 0569 0569 0569 0569 0569 0569 0569 0569 0033 0033 0569 0569 0569 0569 0569 0569 0569 0569 0033 0569 0569 0569 0569 0550 0033 0033 0033 0033 0569 0569 0569 0569 0569 0569 0569 0569 0569 0569 0569 0569 0569 0550 0551 0552 0569 0249 0250 0250 0251 0569 0569 0569 0033 0033 0033 0033 0033 0033 0569 0569 0569 0569 0569 0569 0033 0033 0569 0569 0569 0569 0033 0033 0551 0552 0569 0569 0569 0569 0569 0569 0569 0569 0569 0569 0569 0028 0028 0028 0028 0028 0028 0552 0569 0569 0569 0569 0569 0569 0569 0286 0569 0569 0569 0002 0002 0039 0002 0039 0002 0039 0002 0002 0000
0000 0002 0002 0040 0002 0002 0569 0569 0569 0569 0569 0569 0569 0569 0569 0569 0569 0569 0569 0249 0250 0250 0251 0569 0569 0569 0033 0033 0033 0033 0033 0033 0569 0249 0250 0251 0569 0033 0033 0033 0569 0569 0033 0033 0033 0033 0033 0561 0562 0563 0569 0569 0569 0569 0569 0569 0569 0569 0569 0569 0569 0569 0033 0033 0569 0569 0569 0569 0569 0569 0569 0569 0033 0569 0569 0569 0569 0561 0033 0033 0033 0033 0569 0569 0569 0569 0569 0569 0569 0569 0569 0569 0569 0569 0569 0561 0562 0563 0569 0569 0033 0033 0569 0569 0569 0569 0033 0033 0033 0033 0033 0033 0569 0569 0569 0569 0569 0569 0033 0033 0569 0569 0569 0569 0033 0033 0562 0563 0569 0569 0569 0569 0569 0569 0569 0569 0569 0569 0569 0028 0028 0028 0028 0028 0028 0563 0569 0569 0569 0569 0569 0569 0569 0028 0569 0569 0569 0002 0002 0040 0002 0040 0002 0040 0002 0002 0000
0000 0000 0000 0000 0000 0000 0000 0000 0000 0000 0000 0000 0000 0000 0000 0000 0000 0569 0569 0569 0033 0033 0569 0569 0569 0569 0033 0033 0033 0033 0033 0033 0569 0569 0033 0569 0569 0033 0033 0033 0569 0569 0033 0033 0033 0033 0033 0569 0569 0569 0569 0249 0250 0250 0251 0569 0569 0569 0569 0569 0249 0250 0250 0250 0251 0569 0249 0250 0250 0250 0251 0569 0033 0569 0569 0569 0569 0569 0033 0033 0033 0033 0569 0569 0569 0569 0569 0569 0569 0569 0569 0569 0569 0569 0569 0569 0569 0569 0569 0569 0033 0033 0569 0569 0569 0569 0033 0033 0033 0033 0033 0033 0569 0569 0249 0250 0251 0569 0033 0033 0569 0569 0569 0569 0033 0033 0569 0569 0569 0569 0000 0000 0000 0000 0000 0000 0000 0000 0000 0000 0000 0000 0000 0000 0000 0000 0000 0000 0000 0000 0000 0000 0000 0000 0000 0000 0000 0000 0000 0000 0000 0000 0000 0000 0000 0000 0000
0000 0000 0000 0000 0000 0000 0000 0000 0000 0000 0000 0000 0000 0000 0000 0000 0000 0569 0569 0569 0033 0033 0569 0569 0569 0569 0033 0033 0033 0033 0033 0033 0569 0569 0033 0569 0569 0033 0033 0033 0569 0569 0033 0033 0033 0033 0033 0569 0569 0569 0569 0569 0033 0033 0569 0569 0569 0569 0569 0569 0569 0033 0033 0033 0569 0569 0569 0033 0033 0033 0569 0569 0033 0569 0569 0569 0569 0569 0033 0033 0033 0033 0569 0569 0569 0569 0569 0569 0569 0569 0569 0569 0569 0569 0569 0569 0569 0569 0569 0569 0033 0033 0569 0569 0569 0569 0033 0033 0033 0033 0033 0033 0569 0569 0569 0033 0569 0569 0033 0033 0569 0569 0569 0569 0033 0033 0569 0569 0569 0569 0000 0000 0000 0000 0000 0000 0000 0000 0000 0000 0000 0000 0000 0000 0000 0000 0000 0000 0000 0000 0000 0000 0000 0000 0000 0000 0000 0000 0000 0000 0000 0000 0000 0000 0000 0000 0000