253 15
128 352
SwimmingAround
0000 0569 0569 0569 0569 0569 0569 0569 0569 0569 0569 0569 0569 0569 0569 0569 0569 0000 0212 0569 0569 0569 0569 0569 0569 0569 0569 0569 0569 0569 0569 0569 0569 0569 0569 0569 0569 0569 0569 0569 0569 0569 0569 0569 0569 0569 0569 0569 0569 0569 0569 0569 0569 0569 0569 0569 0569 0569 0569 0569 0569 0569 0569 0569 0569 0569 0569 0569 0569 0569 0569 0569 0569 0569 0569 0569 0569 0569 0569 0569 0569 0569 0569 0569 0569 0569 0569 0569 0569 0569 0569 0569 0569 0569 0569 0569 0569 0569 0569 0569 0569 0569 0569 0569 0569 0569 0569 0569 0569 0569 0569 0569 0569 0569 0569 0569 0569 0569 0569 0569 0569 0569 0569 0569 0569 0569 0569 0569 0569 0569 0569 0569 0569 0569 0569 0569 0569 0569 0569 0569 0569 0569 0569 0569 0569 0569 0569 0569 0569 0569 0569 0569 0569 0569 0569 0569 0569 0569 0569 0569 0569 0569 0569 0569 0569 0569 0569 0569 0569 0569 0569 0569 0569 0569 0569 0569 0569 0569 0569 0569 0569 0569 0569 0569 0569 0569 0569 0569 0569 0569 0569 0569 0569 0569 0569 0569 0569 0569 0569 0569 0569 0569 0569 0569 0569 0569 0569 0569 0569 0569 0569 0569 0569 0212 0000 0569 0569 0569 0569 0569 0569 0569 0569 0569 0569 0569 0569 0569 0569 0569 0569 0569 0569 0569 0569 0569 0569 0569 0569 0569 0569 0569 0569 0569 0569 0569 0569 0569 0569 0569 0569 0569 0000
0000 0569 0569 0569 0569 0569 0569 0569 0569 0569 0569 0569 0569 0569 0569 0569 0569 0000 0212 0569 0569 0569 0569 0569 0569 0569 0569 0569 0569 0569 0569 0569 0569 0569 0569 0569 0569 0569 0569 0569 0569 0569 0569 0569 0569 0569 0569 0569 0569 0569 0569 0569 0569 0569 0569 0569 0569 0569 0569 0569 0569 0569 0569 0569 0569 0569 0569 0569 0569 0569 0569 0569 0569 0569 0569 0569 0569 0569 0569 0569 0569 0569 0569 0569 0569 0569 0569 0569 0569 0569 0569 0569 0569 0569 0569 0569 0569 0569 0569 0569 0569 0569 0569 0569 0569 0569 0569 0569 0569 0569 0569 0569 0569 0569 0569 0569 0569 0569 0569 0569 0569 0569 0569 0569 0569 0569 0569 0569 0569 0569 0569 0569 0569 0569 0569 0569 0569 0569 0569 0569 0569 0569 0569 0569 0569 0569 0569 0569 0569 0569 0569 0569 0569 0569 0569 0569 0569 0569 0569 0569 0569 0569 0569 0569 0569 0569 0569 0569 0569 0569 0569 0569 0569 0569 0569 0569 0569 0569 0569 0569 0569 0569 0569 0569 0569 0569 0569 0569 0569 0569 0569 0569 0569 0569 0569 0569 0569 0569 0569 0569 0569 0569 0569 0569 0569 0569 0569 0569 0569 0569 0569 0569 0569 0212 0000 0569 0569 0569 0569 0569 0569 0569 0569 0569 0569 0569 0569 0569 0569 0569 0569 0569 0569 0569 0569 0569 0569 0569 0569 0569 0569 0569 0569 0569 0569 0569 0569 0569 0569 0569 0569 0569 0000
0000 0569 0569 0569 0569 0569 0569 0569 0569 0569 0569 0569 0569 0569 0569 0569 0569 0000 0212 0612 0612 0612 0612 0612 0612 0612 0612 0612 0612 0612 0612 0612 0612 0612 0612 0612 0612 0612 0612 0612 0612 0612 0612 0612 0612 0612 0612 0612 0612 0612 0612 0612 0612 0612 0612 0612 0612 0612 0612 0612 0612 0612 0612 0612 0612 0612 0612 0612 0612 0612 0612 0612 0612 0612 0612 0612 0612 0612 0612 0612 0612 0612 0612 0612 0612 0612 0612 0612 0612 0612 0612 0612 0612 0612 0612 0612 0612 0612 0212 0212 0612 0612 0612 0612 0612 0612 0612 0612 0612 0612 0612 0612 0612 0612 0612 0612 0612 0612 0612 0612 0612 0612 0612 0612 0612 0612 0612 0612 0612 0612 0612 0612 0612 0612 0612 0612 0612 0612 0612 0612 0612 0612 0612 0612 0612 0612 0612 0612 0612 0612 0612 0212 0612 0612 0612 0612 0612 0612 0612 0612 0612 0612 0612 0612 0612 0612 0612 0612 0612 0612 0612 0612 0612 0612 0612 0612 0612 0612 0612 0612 0612 0612 0612 0612 0612 0612 0612 0612 0612 0612 0612 0612 0612 0612 0612 0612 0612 0612 0612 0612 0612 0612 0612 0612 0612 0612 0612 0612 0212 0212 0212 0212 0212 0212 0000 0569 0569 0569 0569 0550 0551 0551 0552 0569 0569 0569 0569 0569 0569 0569 0569 0569 0569 0569 0569 0569 0569 0225 0569 0569 0569 0569 0569 0569 0569 0569 0569 0569 0569 0569 0550 0551 0000
0000 0569 0569 0569 0550 0551 0551 0552 0569 0569 0569 0569 0569 0569 0569 0569 0569 0000 0212 0623 0623 0623 0623 0623 0623 0623 0623 0623 0623 0623 0623 0623 0623 0623 0623 0623 0623 0623 0623 0623 0623 0623 0623 0623 0623 0623 0623 0623 0623 0623 0623 0623 0623 0623 0623 0623 0623 0623 0623 0623 0623 0623 0623 0623 0623 0623 0623 0623 0623 0623 0623 0623 0623 0623 0623 0623 0623 0623 0623 0623 0623 0623 0623 0623 0623 0623 0623 0623 0623 0623 0623 0623 0623 0623 0623 0623 0623 0623 0212 0212 0623 0623 0623 0510 0623 0623 0623 0623 0623 0623 0623 0623 0623 0623 0623 0623 0623 0623 0623 0623 0623 0623 0623 0623 0623 0623 0623 0623 0623 0623 0623 0623 0623 0623 0623 0623 0623 0623 0623 0623 0623 0623 0623 0623 0623 0623 0623 0623 0623 0623 0623 0212 0623 0623 0623 0623 0623 0623 0623 0623 0623 0623 0623 0623 0623 0623 0623 0623 0623 0623 0623 0623 0623 0623 0623 0623 0623 0623 0623 0623 0623 0623 0623 0623 0623 0623 0623 0623 0623 0623 0623 0623 0623 0510 0623 0623 0623 0623 0623 0623 0623 0623 0623 0623 0623 0623 0623 0623 0212 0212 0212 0212 0212 0212 0000 0569 0569 0569 0569 0561 0562 0562 0563 0569 0569 0569 0569 0569 0569 0569 0569 0569 0569 0569 0569 0569 0999 0286 0569 0550 0551 0552 0569 0569 0569 0569 0569 0569 0569 0569 0561 0562 0000
0000 0569 0569 0569 0561 0562 0562 0563 0569 0569 0569 0569 0569 0569 0569 0569 0569 0000 0212 0623 0623 0623 0623 0623 0623 0623 0623 0623 0623 0623 0623 0623 0623 0623 0623 0623 0623 0623 0623 0623 0623 0623 0623 0623 0623 0623 0623 0623 0623 0623 0623 0623 0623 0623 0623 0623 0623 0623 0623 0623 0623 0623 0623 0623 0623 0623 0623 0623 0623 0623 0623 0623 0623 0623 0623 0623 0623 0623 0623 0623 0623 0623 0623 0623 0623 0623 0623 0623 0623 0623 0623 0623 0623 0623 0623 0623 0623 0623 0212 0212 0623 0623 0623 0510 0623 0623 0623 0623 0623 0623 0623 0623 0623 0623 0623 0623 0623 0623 0623 0623 0623 0623 0623 0623 0623 0623 0623 0623 0623 0623 0623 0623 0623 0623 0623 0623 0623 0623 0623 0623 0623 0623 0623 0623 0623 0623 0623 0623 0623 0623 0623 0212 0212 0212 0212 0212 0212 0212 0212 0212 0623 0623 0623 0623 0623 0623 0623 0623 0623 0623 0623 0623 0623 0623 0623 0623 0623 0623 0623 0623 0623 0623 0623 0623 0623 0623 0623 0623 0623 0623 0623 0623 0623 0510 0623 0623 0623 0623 0623 0623 0623 0623 0623 0623 0623 0623 0623 0623 0212 0212 0212 0212 0212 0212 0000 0569 0569 0569 0569 0569 0569 0569 0569 0569 0569 0569 0569 0569 0569 0569 0569 0569 0569 0569 0569 0569 0569 0286 0569 0561 0562 0563 0569 0569 0569 0569 0569 0569 0569 0569 0569 0569 0000
0000 0569 0569 0569 0569 0569 0569 0569 0569 0569 0569 0569 0569 0569 0569 0569 0569 0000 0212 0623 0623 0623 0623 0623 0623 0623 0623 0623 0623 0623 0623 0623 0623 0623 0623 0623 0623 0623 0623 0623 0623 0623 0623 0623 0623 0623 0623 0623 0623 0623 0623 0623 0623 0623 0623 0623 0623 0623 0623 0623 0623 0623 0623 0623 0623 0623 0623 0623 0623 0623 0623 0623 0623 0623 0623 0623 0623 0623 0623 0623 0623 0623 0623 0623 0623 0623 0623 0623 0623 0623 0623 0623 0623 0623 0623 0623 0623 0623 0623 0623 0623 0623 0212 0212 0212 0623 0623 0623 0623 0623 0623 0623 0623 0623 0623 0623 0623 0623 0623 0623 0623 0623 0510 0623 0623 0623 0623 0623 0623 0623 0623 0623 0623 0623 0623 0623 0623 0623 0623 0623 0623 0623 0623 0623 0623 0623 0623 0623 0623 0623 0623 0623 0623 0623 0623 0623 0623 0623 0623 0623 0623 0623 0623 0623 0623 0623 0623 0623 0623 0623 0623 0623 0623 0623 0623 0623 0212 0212 0212 0623 0623 0623 0212 0212 0212 0623 0623 0623 0623 0623 0623 0623 0212 0212 0212 0212 0212 0623 0623 0623 0212 0212 0212 0212 0623 0623 0623 0623 0212 0212 0212 0212 0212 0212 0000 0569 0569 0569 0569 0569 0569 0569 0569 0569 0569 0569 0569 0028 0028 0569 0569 0569 0569 0569 0569 0569 0569 0286 0569 0569 0569 0569 0569 0569 0569 0569 0569 0569 0569 0569 0569 0569 0000
0000 0569 0569 0569 0569 0569 0569 0569 0569 0569 0569 0569 0569 0569 0569 0569 0569 0000 0212 0623 0623 0623 0623 0623 0623 0623 0623 0623 0623 0623 0623 0623 0623 0623 0623 0623 0623 0623 0623 0623 0623 0623 0623 0623 0623 0623 0623 0623 0623 0623 0623 0623 0623 0623 0623 0623 0623 0623 0623 0623 0623 0623 0623 0623 0623 0623 0623 0623 0623 0623 0623 0623 0623 0623 0623 0623 0623 0623 0623 0623 0623 0623 0623 0623 0623 0623 0623 0623 0623 0623 0623 0623 0623 0623 0623 0623 0623 0623 0623 0623 0623 0623 0623 0623 0623 0623 0623 0623 0623 0623 0623 0623 0623 0623 0623 0623 0623 0623 0623 0623 0623 0623 0510 0623 0623 0623 0623 0623 0623 0623 0623 0623 0623 0623 0623 0623 0623 0623 0623 0623 0623 0623 0623 0623 0623 0623 0623 0623 0623 0623 0623 0623 0623 0623 0623 0623 0623 0623 0623 0623 0623 0623 0623 0623 0623 0623 0623 0623 0623 0623 0623 0623 0623 0623 0623 0623 0212 0623 0623 0623 0623 0623 0623 0623 0212 0623 0623 0623 0623 0623 0623 0623 0623 0623 0623 0623 0623 0623 0623 0623 0623 0623 0623 0623 0623 0623 0623 0623 0623 0623 0212 0212 0212 0212 0000 0569 0569 0569 0569 0569 0569 0569 0569 0569 0569 0569 0028 0028 0028 0569 0569 0569 0569 0569 0569 0569 0569 0286 0569 0569 0569 0569 0569 0569 0569 0569 0569 0569 0569 0569 0569 0569 0000
0000 0569 0569 0569 0569 0569 0569 0569 0569 0569 0550 0551 0552 0569 0569 0569 0569 0000 0212 0623 0623 0623 0623 0623 0623 0623 0623 0623 0623 0623 0623 0623 0623 0623 0623 0623 0623 0623 0623 0623 0623 0623 0623 0623 0623 0623 0623 0623 0623 0623 0623 0623 0623 0623 0623 0623 0623 0623 0623 0623 0623 0623 0510 0623 0623 0623 0623 0623 0623 0623 0623 0623 0623 0623 0623 0623 0623 0623 0623 0623 0623 0623 0623 0623 0623 0623 0623 0623 0623 0623 0623 0623 0623 0623 0623 0623 0623 0623 0623 0623 0623 0623 0623 0623 0623 0623 0623 0623 0623 0623 0623 0623 0623 0623 0623 0623 0623 0623 0623 0623 0623 0623 0510 0623 0623 0623 0623 0623 0623 0623 0623 0623 0623 0623 0623 0623 0623 0623 0623 0623 0623 0623 0623 0623 0623 0623 0623 0623 0623 0623 0623 0623 0623 0623 0623 0623 0623 0623 0623 0623 0623 0623 0623 0623 0623 0623 0623 0623 0623 0623 0623 0623 0623 0623 0623 0623 0212 0623 0623 0623 0623 0623 0623 0623 0212 0623 0623 0623 0623 0623 0623 0623 0623 0623 0623 0623 0623 0623 0623 0623 0623 0623 0623 0623 0623 0623 0623 0623 0623 0246 0212 0212 0212 0212 0000 0569 0569 0569 0569 0569 0569 0569 0569 0569 0569 0028 0028 0028 0028 0569 0569 0569 0569 0569 0569 0569 0569 0286 0569 0569 0569 0569 0569 0569 0569 0569 0569 0569 0569 0569 0569 0569 0000
0000 0569 0011 0011 0011 0569 0569 0569 0569 0569 0561 0562 0563 0569 0569 0569 0569 0000 0212 0623 0623 0623 0623 0623 0623 0623 0623 0623 0623 0623 0623 0623 0623 0623 0623 0623 0623 0623 0623 0623 0623 0623 0623 0623 0623 0623 0623 0623 0623 0623 0623 0623 0623 0510 0623 0623 0623 0623 0623 0623 0623 0623 0510 0623 0623 0623 0623 0623 0623 0623 0623 0623 0623 0623 0623 0623 0623 0623 0623 0623 0623 0623 0623 0623 0623 0212 0623 0623 0623 0623 0623 0212 0623 0623 0623 0623 0623 0623 0623 0623 0623 0623 0623 0623 0623 0623 0623 0623 0623 0623 0623 0623 0623 0623 0623 0623 0623 0623 0623 0623 0623 0623 0510 0623 0623 0623 0623 0623 0623 0623 0623 0623 0623 0623 0623 0212 0212 0623 0623 0623 0623 0623 0623 0623 0623 0623 0623 0623 0623 0623 0623 0623 0623 0623 0623 0623 0623 0623 0623 0623 0623 0623 0623 0623 0623 0623 0623 0623 0623 0623 0623 0623 0623 0623 0623 0623 0212 0623 0623 0623 0623 0623 0623 0623 0212 0623 0623 0623 0623 0623 0623 0623 0623 0623 0623 0623 0623 0623 0623 0623 0623 0623 0623 0623 0623 0623 0623 0623 0623 0272 0212 0212 0212 0212 0000 0569 0569 0569 0569 0569 0569 0569 0569 0569 0028 0028 0028 0028 0028 0569 0569 0569 0569 0569 0569 0569 0569 0286 0569 0569 0569 0569 0011 0011 0011 0569 0569 0569 0569 0569 0569 0569 0000
0000 0569 0012 0002 0014 0569 0569 0569 0569 0569 0569 0569 0569 0244 0245 0569 0569 0000 0212 0623 0623 0623 0623 0623 0623 0623 0623 0623 0623 0623 0623 0623 0623 0623 0623 0623 0623 0212 0212 0212 0623 0623 0623 0623 0623 0623 0623 0623 0623 0623 0623 0623 0623 0510 0623 0623 0623 0623 0623 0623 0623 0623 0212 0212 0623 0623 0623 0623 0623 0623 0510 0623 0623 0623 0623 0623 0623 0623 0623 0623 0623 0623 0623 0623 0623 0212 0623 0623 0623 0623 0623 0212 0623 0623 0623 0623 0623 0623 0623 0623 0623 0623 0623 0623 0623 0623 0623 0623 0623 0623 0623 0623 0623 0623 0623 0623 0623 0623 0623 0623 0623 0623 0212 0212 0623 0623 0623 0623 0623 0623 0623 0623 0623 0623 0623 0623 0623 0623 0623 0623 0510 0623 0623 0623 0623 0623 0623 0623 0623 0212 0623 0623 0623 0623 0623 0623 0623 0623 0623 0623 0623 0212 0623 0623 0623 0623 0623 0623 0623 0623 0623 0623 0623 0623 0623 0623 0212 0623 0623 0623 0623 0623 0623 0623 0212 0623 0623 0623 0623 0623 0623 0623 0212 0212 0212 0212 0212 0623 0623 0623 0212 0212 0212 0212 0623 0623 0623 0623 0212 0212 0212 0212 0212 0212 0000 0569 0569 0569 0569 0569 0569 0569 0569 0028 0028 0028 0028 0028 0028 0569 0569 0569 0569 0569 0569 0569 0569 0286 0569 0569 0569 0569 0012 0002 0014 0569 0569 0569 0569 0569 0569 0569 0000
0000 0011 0038 0038 0038 0011 0569 0569 0569 0569 0569 0569 0569 0270 0271 0569 0569 0000 0212 0623 0623 0623 0623 0623 0623 0623 0623 0623 0623 0623 0510 0623 0623 0623 0623 0623 0623 0623 0623 0623 0623 0623 0623 0623 0623 0623 0623 0623 0623 0623 0623 0623 0623 0510 0623 0623 0623 0623 0623 0623 0623 0623 0623 0623 0623 0623 0623 0623 0623 0623 0510 0623 0623 0623 0623 0623 0623 0623 0623 0623 0623 0623 0623 0623 0212 0212 0623 0623 0623 0623 0623 0212 0212 0623 0623 0623 0623 0623 0212 0212 0623 0623 0623 0623 0623 0623 0623 0623 0623 0510 0623 0623 0623 0623 0623 0623 0623 0623 0623 0623 0623 0623 0623 0623 0623 0623 0623 0623 0623 0623 0623 0623 0623 0623 0623 0623 0623 0623 0623 0623 0510 0623 0623 0623 0623 0623 0623 0623 0623 0212 0623 0623 0623 0623 0623 0623 0623 0623 0623 0623 0623 0212 0623 0623 0623 0623 0623 0623 0623 0510 0623 0623 0623 0623 0623 0623 0212 0623 0623 0623 0623 0623 0623 0623 0212 0623 0623 0623 0623 0623 0623 0623 0623 0623 0623 0623 0623 0623 0623 0623 0623 0623 0623 0623 0623 0623 0623 0212 0212 0212 0212 0212 0212 0212 0000 0569 0569 0569 0569 0569 0569 0569 0028 0028 0028 0028 0028 0028 0028 0569 0569 0569 0569 0253 0569 0569 0569 0286 0569 0569 0569 0011 0038 0038 0038 0011 0569 0569 0569 0569 0569 0569 0000
0000 0002 0002 0039 0002 0002 0569 0569 0569 0569 0569 0246 0247 0248 0271 0569 0569 0000 0212 0623 0623 0623 0623 0623 0623 0623 0623 0623 0623 0623 0510 0623 0623 0623 0623 0623 0623 0623 0623 0623 0623 0623 0623 0623 0623 0623 0623 0623 0623 0623 0623 0623 0623 0510 0623 0623 0623 0623 0623 0623 0623 0623 0623 0623 0623 0623 0623 0623 0623 0623 0510 0623 0623 0623 0623 0623 0623 0623 0623 0623 0623 0623 0623 0623 0212 0212 0623 0623 0623 0623 0623 0212 0212 0623 0623 0623 0623 0623 0212 0212 0623 0623 0623 0623 0623 0623 0623 0623 0623 0510 0623 0623 0623 0623 0623 0623 0623 0623 0623 0623 0623 0623 0623 0623 0623 0623 0623 0623 0623 0623 0623 0623 0623 0623 0623 0623 0623 0623 0623 0623 0510 0623 0623 0623 0623 0623 0623 0623 0623 0212 0212 0623 0623 0623 0623 0623 0623 0623 0623 0623 0212 0212 0623 0623 0623 0623 0623 0510 0623 0510 0623 0623 0623 0623 0623 0623 0212 0623 0623 0623 0623 0623 0623 0623 0212 0623 0623 0623 0623 0623 0623 0623 0623 0623 0623 0623 0623 0623 0623 0623 0623 0623 0623 0623 0623 0623 0212 0212 0212 0212 0212 0212 0212 0212 0000 0569 0569 0569 0244 0245 0569 0028 0028 0028 0028 0028 0028 0028 0028 0569 0569 0569 0252 0278 0254 0569 0569 0286 0569 0569 0569 0002 0002 0039 0002 0002 0569 0569 0253 0569 0569 0569 0000
0000 0002 0002 0040 0002 0002 0569 0569 0569 0569 0569 0272 0273 0274 0271 0569 0569 0000 0212 0623 0623 0623 0623 0623 0623 0623 0623 0623 0623 0623 0510 0623 0623 0623 0623 0623 0623 0623 0623 0623 0623 0623 0623 0623 0623 0623 0623 0623 0623 0623 0623 0623 0623 0510 0623 0623 0623 0623 0623 0623 0623 0623 0623 0623 0623 0623 0623 0623 0623 0623 0510 0623 0623 0623 0623 0623 0623 0623 0623 0623 0623 0623 0623 0623 0212 0212 0623 0623 0623 0623 0623 0212 0212 0623 0623 0623 0623 0623 0212 0212 0623 0623 0623 0623 0623 0623 0623 0623 0623 0510 0623 0623 0623 0623 0623 0623 0623 0623 0623 0623 0623 0623 0623 0623 0623 0623 0623 0623 0623 0623 0623 0623 0623 0623 0623 0623 0623 0623 0623 0623 0510 0623 0623 0623 0623 0623 0623 0623 0623 0212 0212 0623 0623 0623 0623 0623 0623 0623 0623 0623 0212 0212 0623 0623 0623 0623 0623 0510 0623 0510 0623 0623 0623 0623 0623 0623 0212 0623 0623 0623 0623 0623 0623 0623 0212 0623 0623 0623 0623 0623 0623 0623 0623 0623 0623 0623 0623 0623 0623 0623 0623 0623 0623 0623 0623 0212 0212 0212 0212 0212 0212 0212 0212 0212 0000 0569 0569 0569 0270 0271 0028 0028 0028 0028 0028 0028 0028 0028 0028 0569 0569 0252 0278 0279 0278 0254 0569 0028 0569 0569 0569 0002 0002 0040 0002 0002 0283 0252 0278 0254 0569 0569 0000
0000 0000 0000 0000 0000 0000 0000 0000 0000 0000 0000 0000 0000 0000 0000 0000 0000 0000 0212 0212 0212 0212 0212 0212 0212 0212 0212 0212 0212 0212 0212 0212 0212 0212 0212 0212 0212 0212 0212 0212 0212 0212 0212 0212 0212 0212 0212 0212 0212 0212 0212 0212 0212 0212 0212 0212 0212 0212 0212 0212 0212 0212 0212 0212 0212 0212 0212 0212 0212 0212 0212 0212 0212 0212 0212 0212 0212 0212 0212 0212 0212 0212 0212 0212 0212 0212 0623 0623 0623 0623 0623 0212 0212 0212 0212 0212 0212 0212 0212 0212 0212 0212 0212 0212 0212 0212 0212 0212 0212 0212 0212 0212 0212 0212 0212 0212 0212 0212 0212 0212 0212 0212 0212 0212 0212 0212 0212 0212 0212 0212 0212 0212 0212 0212 0212 0212 0212 0212 0212 0212 0212 0212 0212 0212 0212 0212 0212 0212 0212 0212 0212 0623 0623 0623 0623 0623 0623 0623 0623 0623 0212 0212 0212 0212 0212 0212 0212 0212 0212 0212 0212 0212 0212 0212 0212 0212 0212 0623 0623 0623 0623 0623 0623 0623 0212 0212 0212 0212 0212 0212 0212 0212 0212 0212 0212 0212 0212 0212 0212 0212 0212 0212 0212 0212 0212 0212 0212 0212 0212 0212 0212 0212 0212 0212 0000 0000 0000 0000 0000 0000 0000 0000 0000 0000 0000 0000 0000 0000 0000 0000 0000 0000 0000 0000 0000 0000 0000 0000 0000 0000 0000 0000 0000 0000 0000 0000 0000 0000 0000 0000 0000 0000 0000
0000 0000 0000 0000 0000 0000 0000 0000 0000 0000 0000 0000 0000 0000 0000 0000 0000 0000 0212 0212 0212 0212 0212 0212 0212 0212 0212 0212 0212 0212 0212 0212 0212 0212 0212 0212 0212 0212 0212 0212 0212 0212 0212 0212 0212 0212 0212 0212 0212 0212 0212 0212 0212 0212 0212 0212 0212 0212 0212 0212 0212 0212 0212 0212 0212 0212 0212 0212 0212 0212 0212 0212 0212 0212 0212 0212 0212 0212 0212 0212 0212 0212 0212 0212 0212 0212 0623 0623 0623 0623 0623 0212 0212 0212 0212 0212 0212 0212 0212 0212 0212 0212 0212 0212 0212 0212 0212 0212 0212 0212 0212 0212 0212 0212 0212 0212 0212 0212 0212 0212 0212 0212 0212 0212 0212 0212 0212 0212 0212 0212 0212 0212 0212 0212 0212 0212 0212 0212 0212 0212 0212 0212 0212 0212 0212 0212 0212 0212 0212 0212 0212 0623 0623 0623 0623 0623 0623 0623 0623 0623 0212 0212 0212 0212 0212 0212 0212 0212 0212 0212 0212 0212 0212 0212 0212 0212 0212 0623 0623 0623 0623 0623 0623 0623 0212 0212 0212 0212 0212 0212 0212 0212 0212 0212 0212 0212 0212 0212 0212 0212 0212 0212 0212 0212 0212 0212 0212 0212 0212 0212 0212 0212 0212 0212 0000 0000 0000 0000 0000 0000 0000 0000 0000 0000 0000 0000 0000 0000 0000 0000 0000 0000 0000 0000 0000 0000 0000 0000 0000 0000 0000 0000 0000 0000 0000 0000 0000 0000 0000 0000 0000 0000 0000
