2 1
301 15
128 352
RunningAbout
0000 0569 0569 0569 0569 0569 0569 0569 0569 0569 0569 0569 0569 0569 0569 0569 0569 0569 0569 0569 0569 0569 0569 0569 0569 0569 0569 0569 0569 0569 0569 0569 0569 0569 0569 0569 0569 0569 0569 0569 0569 0569 0569 0569 0569 0569 0569 0569 0569 0569 0569 0569 0569 0569 0569 0569 0569 0569 0569 0569 0569 0569 0569 0569 0569 0569 0569 0569 0569 0569 0569 0569 0569 0569 0569 0569 0569 0569 0569 0569 0569 0569 0569 0569 0999 0569 0569 0569 0569 0569 0569 0569 0569 0569 0569 0569 0569 0569 0569 0569 0569 0569 0569 0569 0569 0569 0569 0569 0569 0569 0569 0569 0569 0569 0569 0569 0569 0569 0569 0569 0569 0569 0569 0569 0569 0569 0569 0569 0569 0569 0569 0569 0569 0569 0569 0569 0569 0569 0569 0569 0569 0569 0569 0569 0569 0569 0569 0569 0569 0569 0569 0569 0569 0569 0569 0569 0569 0569 0569 0569 0569 0569 0569 0569 0569 0569 0569 0569 0569 0569 0569 0569 0569 0569 0569 0569 0569 0569 0569 0569 0569 0569 0569 0569 0569 0569 0569 0569 0569 0569 0569 0569 0569 0569 0569 0569 0569 0569 0569 0569 0569 0569 0000 0565 0569 0569 0569 0569 0569 0569 0569 0569 0569 0569 0569 0569 0569 0569 0569 0569 0569 0569 0569 0569 0569 0569 0569 0569 0569 0569 0569 0569 0569 0569 0569 0569 0569 0569 0569 0569 0569 0569 0569 0569 0569 0569 0569 0569 0569 0569 0569 0569 0569 0569 0569 0569 0569 0569 0569 0569 0569 0569 0569 0569 0569 0569 0569 0569 0569 0569 0569 0569 0569 0569 0569 0569 0569 0569 0569 0569 0569 0569 0565 0061 0570 0570 0570 0570 0570 0570 0570 0570 0570 0570 0570 0570 0570 0570 0570 0570 0061
0000 0569 0569 0569 0569 0569 0569 0569 0569 0569 0569 0569 0569 0569 0569 0569 0569 0569 0569 0569 0569 0569 0569 0569 0569 0569 0569 0569 0569 0569 0569 0569 0569 0569 0569 0569 0569 0569 0569 0569 0569 0569 0569 0569 0569 0569 0569 0569 0569 0569 0569 0569 0569 0569 0569 0569 0569 0569 0569 0569 0569 0569 0569 0569 0569 0569 0569 0569 0569 0569 0569 0569 0569 0569 0569 0569 0569 0569 0569 0569 0569 0569 0569 0569 0999 0569 0569 0569 0569 0569 0569 0569 0569 0569 0569 0569 0569 0569 0569 0569 0569 0569 0569 0569 0569 0569 0569 0569 0569 0569 0569 0569 0569 0569 0569 0569 0569 0569 0569 0569 0569 0569 0569 0569 0569 0569 0569 0569 0569 0569 0569 0569 0569 0569 0569 0569 0569 0569 0569 0569 0569 0569 0569 0569 0569 0569 0569 0569 0569 0569 0569 0569 0569 0569 0569 0569 0569 0569 0569 0569 0569 0569 0569 0569 0569 0569 0569 0569 0569 0569 0569 0569 0569 0569 0569 0569 0569 0569 0569 0569 0569 0569 0569 0569 0569 0569 0569 0569 0569 0569 0569 0569 0569 0569 0569 0569 0569 0569 0569 0569 0569 0569 0000 0565 0569 0569 0569 0569 0569 0569 0569 0569 0569 0569 0569 0569 0569 0569 0569 0569 0569 0569 0569 0569 0569 0569 0569 0569 0569 0569 0569 0569 0569 0569 0569 0569 0569 0569 0569 0569 0569 0569 0569 0569 0569 0569 0569 0569 0569 0569 0569 0569 0569 0569 0569 0569 0569 0569 0569 0569 0569 0569 0569 0569 0569 0569 0569 0569 0569 0569 0569 0569 0569 0569 0569 0569 0569 0569 0569 0569 0569 0569 0565 0061 0570 0570 0570 0570 0570 0570 0570 0570 0570 0570 0570 0570 0570 0570 0570 0570 0061
0000 0569 0011 0011 0011 0569 0569 0569 0569 0569 0569 0569 0569 0569 0569 0569 0569 0569 0569 0569 0569 0569 0569 0569 0569 0569 0569 0569 0550 0551 0552 0569 0569 0569 0569 0569 0569 0569 0569 0569 0569 0569 0569 0569 0569 0569 0550 0551 0552 0569 0569 0569 0569 0569 0569 0569 0569 0569 0569 0569 0569 0569 0569 0569 0569 0569 0569 0569 0569 0569 0569 0569 0569 0569 0569 0569 0550 0551 0552 0569 0569 0569 0569 0569 0999 0569 0569 0569 0569 0569 0569 0569 0569 0569 0550 0551 0552 0569 0569 0569 0569 0569 0569 0569 0569 0569 0569 0569 0569 0569 0569 0550 0551 0552 0569 0569 0569 0569 0569 0569 0569 0569 0569 0569 0569 0569 0569 0569 0550 0551 0552 0569 0569 0569 0569 0569 0569 0569 0569 0569 0569 0569 0569 0569 0569 0569 0569 0569 0569 0569 0569 0569 0569 0569 0569 0569 0569 0569 0569 0550 0551 0552 0569 0569 0569 0569 0569 0569 0569 0569 0569 0569 0569 0569 0569 0569 0569 0550 0551 0552 0569 0569 0569 0569 0569 0569 0569 0569 0225 0569 0569 0569 0569 0569 0569 0569 0569 0569 0569 0569 0569 0569 0000 0565 0569 0569 0569 0569 0569 0569 0569 0569 0569 0569 0569 0569 0569 0569 0569 0569 0569 0569 0569 0569 0569 0569 0569 0569 0569 0569 0569 0569 0569 0569 0569 0569 0569 0569 0569 0569 0569 0569 0569 0569 0569 0569 0569 0569 0569 0569 0569 0569 0569 0569 0569 0569 0569 0569 0569 0569 0569 0569 0569 0569 0569 0569 0569 0569 0569 0569 0569 0569 0569 0569 0569 0569 0569 0569 0569 0569 0569 0569 0565 0061 0063 0570 0570 0570 0063 0063 0063 0063 0063 0063 0063 0570 0570 0570 0570 0270 0061
0000 0569 0012 0002 0014 0569 0569 0569 0569 0569 0569 0569 0569 0569 0569 0569 0569 0569 0569 0550 0551 0552 0569 0569 0569 0569 0569 0569 0561 0562 0563 0550 0551 0551 0552 0569 0569 0569 0569 0569 0569 0569 0569 0569 0569 0569 0561 0562 0563 0550 0551 0551 0552 0569 0569 0569 0569 0569 0569 0569 0569 0569 0569 0569 0569 0569 0569 0550 0551 0552 0569 0569 0569 0569 0569 0569 0561 0562 0563 0550 0551 0551 0552 0569 0999 0569 0569 0569 0569 0569 0569 0569 0569 0569 0561 0562 0563 0550 0551 0551 0552 0569 0569 0569 0569 0569 0569 0569 0569 0569 0569 0561 0562 0563 0550 0551 0551 0552 0569 0569 0569 0569 0569 0569 0569 0569 0569 0569 0561 0562 0563 0550 0551 0551 0552 0569 0569 0569 0569 0569 0569 0569 0569 0569 0569 0569 0569 0569 0569 0569 0550 0551 0552 0569 0569 0569 0569 0569 0569 0561 0562 0563 0550 0551 0551 0552 0569 0569 0569 0569 0569 0569 0569 0569 0569 0569 0569 0561 0028 0028 0550 0551 0551 0552 0569 0569 0569 0999 0286 0569 0550 0551 0552 0569 0569 0569 0569 0569 0550 0551 0552 0569 0000 0565 0569 0569 0569 0569 0569 0569 0569 0569 0569 0569 0569 0569 0569 0569 0569 0569 0569 0569 0569 0569 0569 0569 0569 0569 0569 0569 0569 0569 0569 0569 0569 0569 0569 0569 0569 0569 0569 0569 0569 0569 0569 0569 0569 0569 0569 0569 0569 0569 0569 0569 0569 0569 0569 0569 0569 0569 0569 0569 0569 0569 0569 0569 0569 0569 0569 0569 0569 0569 0569 0569 0569 0569 0569 0569 0569 0569 0569 0569 0565 0061 0063 0570 0570 0570 0570 0570 0570 0570 0570 0570 0570 0570 0570 0570 0570 0270 0061
0000 0011 0038 0038 0038 0011 0569 0569 0569 0569 0569 0569 0569 0569 0569 0569 0569 0569 0569 0561 0562 0563 0569 0569 0569 0569 0569 0569 0569 0569 0569 0561 0562 0562 0563 0569 0569 0569 0569 0569 0569 0569 0569 0569 0569 0569 0569 0569 0569 0561 0562 0562 0563 0569 0569 0569 0569 0569 0569 0569 0569 0569 0569 0569 0569 0569 0569 0561 0562 0563 0569 0569 0569 0569 0569 0569 0569 0569 0569 0561 0562 0562 0563 0569 0999 0569 0569 0569 0569 0569 0569 0569 0569 0569 0569 0569 0569 0561 0562 0562 0563 0569 0569 0569 0569 0569 0569 0569 0569 0569 0569 0569 0569 0569 0561 0562 0562 0563 0569 0569 0569 0569 0569 0569 0569 0569 0569 0569 0569 0569 0569 0561 0562 0562 0563 0569 0569 0569 0569 0569 0569 0569 0569 0569 0569 0569 0569 0569 0569 0569 0561 0562 0563 0569 0569 0569 0569 0569 0569 0569 0569 0569 0561 0562 0562 0563 0569 0569 0569 0569 0569 0569 0569 0569 0569 0569 0569 0569 0028 0028 0561 0562 0562 0563 0569 0569 0569 0569 0286 0569 0561 0562 0563 0569 0569 0569 0569 0569 0561 0562 0563 0569 0000 0565 0569 0569 0569 0569 0569 0569 0569 0569 0569 0569 0569 0569 0569 0569 0569 0569 0569 0569 0569 0569 0569 0569 0569 0569 0569 0569 0569 0569 0569 0569 0569 0569 0569 0569 0569 0569 0569 0569 0569 0569 0569 0569 0569 0569 0569 0569 0569 0569 0569 0569 0569 0569 0569 0569 0569 0569 0569 0569 0569 0569 0569 0569 0569 0569 0569 0569 0569 0569 0569 0569 0569 0569 0569 0569 0569 0569 0569 0569 0565 0061 0063 0570 0570 0570 0570 0570 0570 0570 0570 0570 0570 0570 0570 0570 0570 0270 0061
0000 0002 0002 0039 0002 0002 0569 0569 0569 0569 0569 0569 0569 0569 0569 0569 0569 0569 0569 0569 0569 0569 0569 0569 0569 0569 0569 0569 0569 0569 0001 0001 0001 0569 0569 0569 0569 0569 0569 0569 0569 0569 0569 0569 0569 0569 0569 0569 0569 0569 0569 0569 0569 0569 0024 0024 0024 0024 0024 0569 0569 0569 0569 0569 0569 0569 0569 0569 0569 0569 0001 0001 0001 0001 0569 0569 0569 0569 0569 0569 0569 0569 0001 0001 0001 0001 0001 0569 0569 0569 0569 0569 0569 0001 0001 0001 0001 0569 0569 0569 0569 0569 0569 0569 0569 0569 0569 0569 0569 0569 0569 0569 0569 0001 0001 0001 0001 0569 0569 0569 0569 0569 0569 0569 0569 0569 0569 0569 0569 0569 0569 0569 0569 0569 0569 0569 0569 0569 0569 0569 0569 0569 0569 0569 0569 0569 0569 0569 0569 0569 0569 0569 0001 0001 0001 0001 0001 0569 0569 0569 0001 0569 0569 0569 0569 0569 0569 0569 0569 0569 0569 0569 0569 0569 0569 0569 0569 0569 0028 0028 0569 0569 0569 0569 0569 0569 0569 0569 0286 0569 0569 0569 0569 0569 0569 0569 0569 0569 0569 0569 0569 0569 0000 0565 0569 0569 0569 0569 0569 0569 0569 0569 0569 0569 0569 0569 0569 0569 0569 0569 0569 0569 0569 0569 0569 0569 0569 0569 0569 0569 0569 0569 0569 0569 0569 0569 0569 0569 0569 0569 0569 0569 0569 0569 0569 0569 0569 0569 0569 0569 0569 0569 0569 0569 0569 0569 0569 0569 0569 0569 0569 0569 0569 0569 0569 0569 0569 0569 0569 0569 0569 0569 0569 0569 0569 0569 0569 0569 0569 0569 0569 0569 0565 0061 0063 0570 0570 0570 0570 0570 0570 0570 0570 0570 0570 0570 0570 0570 0570 0270 0061
0000 0002 0002 0040 0002 0002 0569 0569 0569 0569 0569 0569 0569 0569 0569 0569 0569 0569 0569 0569 0569 0569 0569 0569 0569 0569 0569 0569 0569 0569 0569 0569 0569 0569 0569 0569 0569 0569 0569 0569 0569 0569 0569 0569 0569 0569 0569 0569 0569 0569 0569 0569 0569 0569 0569 0569 0569 0569 0569 0569 0569 0569 0569 0569 0569 0569 0569 0569 0569 0569 0569 0569 0569 0569 0569 0569 0569 0569 0569 0569 0569 0569 0569 0569 0569 0569 0569 0569 0569 0569 0569 0569 0569 0569 0569 0569 0569 0569 0569 0569 0569 0569 0569 0569 0569 0569 0569 0569 0569 0569 0569 0569 0569 0569 0569 0569 0569 0569 0569 0569 0569 0569 0569 0569 0569 0569 0569 0569 0569 0569 0569 0569 0569 0569 0569 0569 0569 0569 0569 0569 0569 0569 0569 0569 0569 0569 0569 0569 0569 0569 0569 0569 0569 0569 0569 0569 0569 0569 0569 0569 0569 0569 0569 0569 0569 0569 0569 0569 0569 0569 0569 0569 0569 0569 0569 0569 0569 0569 0028 0028 0569 0569 0569 0569 0569 0569 0569 0569 0286 0569 0569 0569 0569 0569 0569 0569 0569 0569 0569 0569 0569 0569 0000 0565 0569 0569 0569 0569 0569 0569 0569 0569 0569 0569 0569 0569 0569 0569 0569 0569 0569 0569 0569 0569 0569 0569 0569 0569 0569 0569 0569 0569 0569 0569 0569 0569 0569 0569 0569 0569 0569 0569 0569 0569 0569 0569 0569 0569 0569 0569 0569 0569 0569 0569 0569 0569 0569 0569 0569 0569 0569 0569 0569 0569 0569 0569 0569 0569 0569 0569 0569 0569 0569 0569 0569 0569 0569 0569 0569 0569 0569 0569 0565 0061 0063 0570 0570 0570 0570 0570 0570 0570 0570 0570 0570 0570 0570 0570 0570 0270 0061
0000 0038 0038 0038 0038 0038 0011 0011 0569 0569 0569 0569 0569 0569 0569 0569 0569 0569 0569 0569 0569 0569 0569 0569 0569 0569 0569 0569 0569 0569 0569 0569 0569 0569 0569 0569 0569 0569 0569 0569 0569 0569 0569 0569 0569 0569 0569 0569 0569 0569 0569 0569 0569 0569 0569 0569 0569 0569 0569 0569 0569 0569 0569 0569 0569 0569 0569 0569 0569 0569 0569 0569 0569 0569 0569 0569 0569 0569 0569 0569 0569 0569 0569 0569 0569 0569 0569 0569 0569 0569 0569 0569 0569 0569 0569 0569 0569 0569 0569 0569 0569 0569 0569 0569 0569 0569 0569 0569 0569 0569 0569 0569 0569 0569 0569 0569 0569 0569 0569 0569 0569 0569 0569 0569 0569 0569 0569 0569 0569 0569 0569 0569 0569 0569 0569 0569 0569 0569 0569 0569 0569 0569 0569 0569 0569 0569 0569 0569 0569 0569 0569 0569 0569 0569 0569 0569 0569 0569 0569 0569 0569 0569 0569 0569 0569 0569 0569 0569 0569 0569 0569 0569 0569 0569 0569 0569 0569 0569 0028 0028 0569 0569 0569 0569 0569 0569 0569 0569 0286 0569 0569 0569 0569 0569 0569 0569 0569 0569 0569 0569 0569 0569 0000 0565 0569 0569 0569 0569 0569 0569 0569 0569 0569 0569 0569 0569 0569 0569 0569 0569 0569 0569 0569 0569 0569 0569 0569 0569 0569 0569 0569 0569 0569 0569 0569 0569 0569 0569 0569 0569 0569 0569 0569 0569 0569 0569 0569 0569 0569 0569 0569 0569 0569 0569 0569 0569 0569 0569 0569 0569 0569 0569 0569 0569 0569 0569 0569 0569 0569 0569 0569 0569 0569 0569 0569 0569 0569 0569 0569 0569 0569 0569 0565 0061 0063 0570 0570 0570 0570 0570 0570 0570 0570 0570 0570 0570 0570 0570 0570 0270 0061
0000 0002 0039 0002 0039 0002 0002 0002 0569 0569 0569 0569 0569 0569 0569 0569 0569 0569 0569 0569 0569 0569 0569 0569 0569 0028 0028 0569 0569 0569 0569 0569 0569 0569 0569 0028 0569 0569 0569 0569 0569 0569 0569 0569 0569 0569 0569 0569 0569 0569 0569 0569 0569 0569 0569 0569 0569 0569 0569 0569 0569 0569 0569 0569 0569 0569 0569 0569 0569 0569 0569 0569 0569 0569 0569 0569 0569 0569 0569 0569 0569 0569 0569 0569 0569 0569 0569 0569 0569 0569 0569 0569 0569 0569 0569 0569 0569 0569 0569 0569 0569 0569 0569 0569 0569 0569 0569 0569 0569 0569 0569 0569 0569 0569 0569 0569 0569 0569 0244 0245 0569 0569 0569 0569 0569 0569 0569 0569 0569 0569 0569 0569 0569 0569 0569 0569 0569 0569 0569 0569 0569 0569 0569 0569 0569 0569 0569 0569 0569 0569 0569 0569 0569 0569 0569 0569 0569 0569 0569 0569 0569 0569 0569 0569 0569 0569 0569 0569 0569 0569 0569 0569 0569 0569 0569 0569 0569 0569 0028 0028 0569 0569 0569 0569 0569 0569 0569 0569 0286 0569 0569 0569 0569 0011 0011 0011 0569 0569 0569 0569 0569 0569 0000 0565 0569 0569 0569 0569 0569 0569 0569 0569 0569 0569 0569 0569 0569 0569 0569 0569 0569 0569 0569 0569 0569 0569 0569 0569 0569 0569 0569 0569 0569 0569 0569 0569 0569 0569 0569 0569 0569 0569 0569 0569 0569 0569 0569 0569 0569 0569 0569 0569 0569 0569 0569 0569 0569 0569 0569 0569 0569 0569 0569 0569 0569 0569 0569 0569 0569 0569 0569 0569 0569 0569 0569 0569 0569 0569 0569 0569 0569 0569 0565 0061 0063 0570 0570 0570 0570 0570 0570 0570 0570 0570 0570 0570 0570 0570 0570 0270 0061
0000 0002 0040 0002 0040 0002 0002 0002 0569 0569 0569 0569 0569 0569 0569 0569 0001 0001 0001 0569 0569 0569 0569 0569 0028 0028 0028 0569 0569 0569 0569 0569 0569 0569 0569 0028 0569 0569 0569 0569 0569 0569 0569 0569 0569 0569 0569 0244 0245 0569 0569 0569 0569 0569 0024 0024 0024 0024 0024 0569 0569 0569 0569 0569 0569 0569 0569 0569 0569 0001 0569 0569 0569 0569 0569 0244 0245 0569 0569 0569 0024 0024 0024 0024 0569 0569 0024 0024 0024 0569 0569 0569 0569 0569 0569 0569 0569 0569 0569 0569 0569 0569 0569 0569 0569 0569 0569 0569 0569 0569 0244 0245 0569 0569 0569 0569 0569 0569 0270 0271 0569 0569 0569 0569 0569 0569 0569 0569 0569 0569 0569 0569 0569 0569 0569 0569 0569 0569 0569 0569 0569 0569 0569 0569 0569 0569 0569 0569 0569 0001 0569 0569 0569 0569 0569 0569 0569 0569 0024 0569 0569 0569 0569 0569 0569 0569 0569 0569 0569 0569 0569 0569 0569 0001 0001 0569 0569 0569 0028 0028 0569 0569 0569 0569 0569 0569 0569 0569 0286 0569 0569 0569 0569 0012 0002 0014 0569 0569 0569 0569 0569 0569 0000 0565 0569 0569 0569 0569 0999 0569 0569 0569 0569 0569 0569 0569 0569 0569 0569 0569 0569 0569 0569 0569 0569 0569 0569 0569 0569 0569 0569 0569 0569 0569 0569 0569 0569 0569 0569 0569 0569 0569 0569 0569 0569 0569 0569 0569 0569 0569 0569 0569 0569 0569 0569 0569 0569 0569 0569 0569 0569 0569 0569 0569 0569 0569 0569 0569 0569 0569 0569 0569 0569 0569 0569 0569 0569 0569 0569 0569 0569 0569 0565 0061 0063 0570 0570 0570 0570 0570 0570 0570 0570 0570 0570 0570 0570 0570 0570 0270 0061
0000 0002 0002 0002 0002 0002 0002 0002 0569 0569 0569 0569 0569 0569 0258 0569 0569 0569 0569 0569 0569 0569 0258 0028 0028 0028 0028 0569 0569 0569 0569 0569 0569 0569 0569 0028 0569 0569 0569 0569 0569 0569 0569 0569 0258 0569 0569 0270 0271 0569 0569 0569 0569 0569 0569 0569 0569 0569 0569 0569 0569 0569 0258 0569 0569 0569 0569 0569 0569 0569 0258 0569 0569 0569 0569 0270 0271 0569 0569 0569 0569 0569 0569 0569 0569 0569 0569 0569 0569 0569 0569 0569 0258 0569 0569 0569 0569 0258 0569 0569 0569 0569 0569 0569 0569 0258 0569 0569 0569 0569 0270 0271 0569 0569 0244 0245 0569 0569 0270 0271 0569 0569 0569 0569 0569 0569 0569 0569 0569 0569 0569 0569 0569 0569 0569 0569 0569 0569 0569 0569 0569 0028 0569 0569 0258 0569 0569 0569 0569 0569 0569 0569 0569 0258 0569 0569 0569 0569 0569 0569 0569 0569 0569 0569 0244 0245 0569 0569 0569 0569 0569 0569 0569 0569 0569 0258 0569 0569 0028 0028 0569 0569 0569 0569 0569 0569 0569 0569 0286 0569 0569 0569 0011 0038 0038 0038 0011 0569 0569 0569 0569 0258 0000 0565 0569 0569 0569 0569 0999 0569 0569 0569 0569 0569 0569 0569 0569 0569 0569 0569 0569 0569 0569 0569 0569 0569 0569 0569 0569 0569 0569 0569 0569 0569 0569 0569 0569 0569 0569 0569 0569 0569 0569 0569 0569 0569 0569 0569 0569 0569 0569 0569 0569 0569 0569 0569 0569 0569 0569 0569 0569 0569 0569 0569 0569 0569 0569 0569 0569 0569 0569 0569 0569 0569 0569 0569 0569 0569 0569 0569 0569 0569 0565 0061 0063 0570 0570 0570 0063 0063 0063 0063 0063 0063 0063 0570 0570 0570 0570 0270 0061
0000 0039 0002 0039 0002 0039 0002 0002 0569 0569 0569 0569 0257 0569 0284 0569 0569 0569 0569 0569 0569 0569 0028 0028 0028 0028 0028 0569 0569 0569 0569 0569 0569 0569 0569 0028 0028 0569 0569 0569 0569 0257 0569 0569 0284 0569 0569 0270 0271 0569 0569 0569 0569 0569 0569 0569 0569 0569 0569 0569 0257 0569 0284 0569 0569 0569 0569 0569 0569 0569 0284 0569 0257 0257 0569 0270 0271 0569 0569 0569 0569 0569 0569 0569 0569 0569 0569 0569 0569 0257 0569 0569 0284 0569 0569 0569 0569 0284 0569 0569 0569 0569 0569 0244 0245 0284 0569 0257 0257 0569 0270 0271 0569 0569 0270 0271 0569 0569 0270 0271 0569 0569 0569 0569 0257 0569 0569 0569 0569 0569 0569 0569 0569 0569 0569 0569 0569 0569 0569 0569 0569 0028 0257 0569 0284 0569 0569 0569 0569 0569 0569 0569 0569 0284 0569 0257 0257 0569 0569 0569 0569 0569 0569 0569 0270 0271 0569 0569 0569 0569 0569 0569 0257 0569 0569 0284 0569 0569 0028 0028 0569 0569 0569 0569 0569 0569 0569 0569 0286 0569 0569 0257 0002 0002 0039 0002 0002 0569 0569 0569 0569 0284 0000 0565 0569 0569 0569 0569 0999 0569 0569 0569 0569 0569 0569 0569 0569 0569 0569 0569 0569 0569 0569 0569 0569 0569 0569 0569 0569 0569 0569 0569 0569 0569 0569 0569 0569 0569 0569 0569 0569 0569 0569 0569 0569 0569 0569 0569 0569 0569 0569 0569 0569 0569 0569 0569 0569 0569 0569 0569 0569 0569 0569 0569 0569 0569 0569 0569 0569 0569 0569 0569 0569 0569 0569 0569 0569 0569 0569 0569 0569 0569 0565 0061 0063 0570 0570 0570 0063 0063 0063 0063 0063 0063 0063 0570 0570 0246 0247 0248 0061
0000 0040 0002 0040 0002 0040 0002 0002 0569 0569 0569 0569 0035 0569 0035 0005 0005 0005 0005 0569 0569 0028 0028 0028 0028 0028 0028 0569 0569 0569 0569 0569 0569 0569 0569 0028 0028 0569 0569 0005 0005 0035 0005 0569 0035 0569 0569 0270 0271 0569 0569 0569 0569 0569 0569 0569 0569 0569 0569 0569 0035 0569 0035 0005 0005 0005 0005 0569 0569 0569 0035 0569 0035 0035 0569 0270 0271 0569 0569 0569 0569 0569 0569 0569 0569 0569 0569 0005 0005 0035 0005 0569 0035 0569 0569 0569 0569 0035 0005 0005 0005 0005 0569 0270 0271 0035 0569 0035 0035 0569 0270 0271 0569 0569 0270 0271 0569 0569 0270 0271 0569 0569 0005 0005 0035 0005 0569 0569 0569 0569 0569 0569 0569 0569 0569 0569 0569 0569 0569 0569 0569 0028 0035 0569 0035 0005 0005 0005 0005 0005 0569 0569 0569 0035 0569 0035 0035 0569 0569 0569 0569 0569 0569 0569 0270 0271 0569 0569 0569 0569 0005 0005 0035 0005 0569 0035 0999 0569 0028 0028 0569 0569 0569 0569 0569 0569 0569 0569 0028 0569 0569 0035 0002 0002 0040 0002 0002 0005 0569 0569 0569 0035 0000 0565 0569 0569 0569 0569 0999 0569 0569 0569 0569 0569 0569 0569 0569 0569 0569 0569 0569 0569 0569 0569 0569 0569 0569 0569 0569 0569 0569 0569 0569 0569 0569 0569 0569 0569 0569 0569 0569 0569 0569 0569 0569 0569 0569 0569 0569 0569 0569 0569 0569 0569 0569 0569 0569 0569 0569 0569 0569 0569 0569 0569 0569 0569 0569 0569 0569 0569 0569 0569 0569 0569 0569 0569 0569 0569 0569 0569 0569 0569 0565 0061 0063 0570 0570 0570 0063 0063 0063 0063 0063 0063 0063 0570 0570 0272 0273 0274 0061
0000 0000 0000 0000 0000 0000 0000 0000 0000 0000 0000 0000 0000 0000 0000 0000 0000 0000 0000 0000 0000 0000 0000 0000 0000 0000 0000 0000 0000 0000 0000 0000 0000 0000 0000 0000 0000 0000 0000 0000 0000 0000 0000 0000 0000 0000 0000 0000 0000 0000 0000 0000 0000 0000 0000 0000 0000 0000 0000 0000 0000 0000 0000 0000 0000 0000 0000 0000 0000 0000 0000 0000 0000 0000 0000 0000 0000 0000 0000 0000 0000 0000 0000 0000 0000 0000 0000 0000 0000 0000 0000 0000 0000 0569 0569 0569 0569 0000 0000 0000 0000 0000 0000 0000 0000 0000 0000 0000 0000 0000 0000 0000 0000 0000 0000 0000 0000 0000 0000 0000 0000 0000 0000 0000 0000 0000 0569 0569 0569 0000 0000 0000 0000 0000 0000 0000 0000 0000 0000 0569 0569 0000 0000 0000 0000 0000 0000 0000 0000 0000 0000 0000 0000 0000 0000 0000 0000 0000 0000 0000 0000 0000 0000 0000 0000 0000 0000 0000 0000 0000 0000 0000 0000 0000 0000 0000 0000 0000 0000 0000 0000 0000 0000 0000 0000 0000 0000 0000 0000 0000 0000 0000 0000 0000 0000 0000 0000 0000 0000 0000 0000 0000 0000 0565 0565 0565 0565 0565 0999 0565 0565 0565 0565 0565 0565 0565 0565 0565 0565 0565 0565 0565 0565 0565 0565 0565 0565 0565 0565 0565 0565 0565 0565 0565 0565 0565 0565 0565 0565 0565 0565 0565 0565 0565 0565 0565 0565 0565 0565 0565 0565 0565 0565 0565 0565 0565 0565 0565 0565 0565 0565 0565 0565 0565 0565 0569 0569 0569 0569 0569 0569 0569 0569 0569 0569 0569 0569 0569 0569 0569 0569 0569 0565 0061 0061 0061 0061 0061 0061 0061 0061 0061 0061 0061 0061 0061 0061 0061 0061 0061 0061
0000 0000 0000 0000 0000 0000 0000 0000 0000 0000 0000 0000 0000 0000 0000 0000 0000 0000 0000 0000 0000 0000 0000 0000 0000 0000 0000 0000 0000 0000 0000 0000 0000 0000 0000 0000 0000 0000 0000 0000 0000 0000 0000 0000 0000 0000 0000 0000 0000 0000 0000 0000 0000 0000 0000 0000 0000 0000 0000 0000 0000 0000 0000 0000 0000 0000 0000 0000 0000 0000 0000 0000 0000 0000 0000 0000 0000 0000 0000 0000 0000 0000 0000 0000 0000 0000 0000 0000 0000 0000 0000 0000 0000 0569 0569 0569 0569 0000 0000 0000 0000 0000 0000 0000 0000 0000 0000 0000 0000 0000 0000 0000 0000 0000 0000 0000 0000 0000 0000 0000 0000 0000 0000 0000 0000 0000 0569 0569 0569 0000 0000 0000 0000 0000 0000 0000 0000 0000 0000 0569 0569 0000 0000 0000 0000 0000 0000 0000 0000 0000 0000 0000 0000 0000 0000 0000 0000 0000 0000 0000 0000 0000 0000 0000 0000 0000 0000 0000 0000 0000 0000 0000 0000 0000 0000 0000 0000 0000 0000 0000 0000 0000 0000 0000 0000 0000 0000 0000 0000 0000 0000 0000 0000 0000 0000 0000 0000 0000 0000 0000 0000 0000 0000 0565 0569 0569 0569 0569 0999 0569 0569 0569 0569 0569 0569 0569 0569 0569 0569 0569 0569 0569 0569 0569 0569 0569 0569 0569 0569 0569 0569 0569 0569 0569 0569 0569 0569 0569 0569 0569 0569 0569 0569 0569 0569 0569 0569 0569 0569 0569 0569 0569 0569 0569 0569 0569 0569 0569 0569 0569 0569 0569 0569 0569 0569 0569 0569 0569 0569 0569 0569 0569 0569 0569 0569 0569 0569 0569 0569 0569 0569 0569 0565 0061 0061 0061 0061 0061 0061 0061 0061 0061 0061 0061 0061 0061 0061 0061 0061 0061 0061
