231 15
128 352
RunningAround
0000 0569 0569 0569 0569 0569 0569 0569 0569 0569 0569 0569 0569 0569 0569 0569 0569 0569 0569 0569 0569 0569 0569 0569 0569 0569 0569 0569 0569 0569 0569 0569 0569 0569 0569 0569 0569 0569 0569 0569 0569 0569 0569 0569 0569 0569 0569 0569 0569 0569 0569 0569 0569 0569 0569 0569 0569 0569 0569 0569 0569 0569 0569 0569 0569 0569 0569 0569 0569 0569 0569 0569 0569 0569 0569 0569 0569 0569 0569 0569 0569 0569 0569 0569 0569 0569 0569 0569 0569 0569 0569 0569 0569 0569 0569 0569 0569 0569 0569 0569 0569 0569 0569 0569 0569 0569 0569 0569 0569 0569 0569 0569 0569 0569 0569 0569 0569 0569 0569 0569 0569 0569 0569 0569 0569 0569 0569 0569 0569 0569 0569 0569 0569 0569 0569 0569 0569 0569 0569 0569 0569 0569 0569 0569 0569 0569 0569 0569 0569 0569 0569 0569 0569 0569 0569 0569 0569 0569 0569 0569 0569 0569 0569 0569 0569 0569 0569 0569 0569 0569 0569 0569 0569 0569 0569 0569 0569 0569 0569 0569 0569 0569 0569 0569 0569 0569 0569 0569 0569 0569 0569 0569 0569 0569 0569 0569 0569 0569 0569 0569 0569 0569 0569 0569 0569 0569 0569 0569 0569 0569 0569 0569 0000 0061 0063 0570 0570 0570 0570 0570 0570 0570 0570 0570 0570 0570 0570 0570 0570 0270 0061
0000 0569 0569 0569 0569 0569 0569 0569 0569 0569 0569 0569 0569 0569 0569 0569 0569 0569 0569 0569 0569 0569 0569 0569 0569 0569 0569 0569 0569 0569 0569 0569 0569 0569 0569 0569 0569 0569 0569 0569 0569 0569 0569 0569 0569 0569 0569 0569 0569 0569 0569 0569 0569 0569 0569 0569 0569 0569 0569 0569 0569 0569 0569 0569 0569 0569 0569 0569 0569 0569 0569 0569 0569 0569 0569 0569 0569 0569 0569 0569 0569 0569 0569 0569 0569 0569 0569 0569 0569 0569 0569 0569 0569 0569 0569 0569 0569 0569 0569 0569 0569 0569 0569 0569 0569 0569 0569 0569 0569 0569 0569 0569 0569 0569 0569 0569 0569 0569 0569 0569 0569 0569 0569 0569 0569 0569 0569 0569 0569 0569 0569 0569 0569 0569 0569 0569 0569 0569 0569 0569 0569 0569 0569 0569 0569 0569 0569 0569 0569 0569 0569 0569 0569 0569 0569 0569 0569 0569 0569 0569 0569 0569 0569 0569 0569 0569 0569 0569 0569 0569 0569 0569 0569 0569 0569 0569 0569 0569 0569 0569 0569 0569 0569 0569 0569 0569 0569 0569 0569 0569 0569 0569 0569 0569 0569 0569 0569 0569 0569 0569 0569 0569 0569 0569 0569 0569 0569 0569 0569 0569 0569 0569 0000 0061 0063 0570 0570 0570 0570 0570 0570 0570 0570 0570 0570 0570 0570 0570 0570 0270 0061
0000 0569 0569 0569 0569 0569 0569 0569 0569 0569 0569 0569 0569 0569 0569 0569 0569 0569 0569 0550 0551 0552 0569 0569 0569 0569 0569 0569 0569 0569 0569 0569 0569 0569 0569 0569 0550 0551 0551 0552 0569 0569 0569 0569 0569 0569 0569 0569 0569 0569 0569 0569 0569 0569 0569 0569 0569 0569 0569 0569 0569 0569 0569 0569 0569 0569 0569 0550 0551 0552 0569 0569 0569 0569 0569 0569 0569 0569 0569 0569 0569 0569 0569 0569 0550 0551 0551 0552 0569 0569 0569 0569 0569 0569 0569 0569 0569 0569 0569 0569 0569 0569 0569 0569 0569 0569 0569 0569 0569 0569 0569 0569 0569 0569 0569 0550 0551 0552 0569 0569 0569 0569 0569 0569 0569 0569 0569 0569 0569 0569 0569 0569 0550 0551 0551 0552 0569 0569 0569 0569 0569 0569 0569 0569 0569 0569 0569 0569 0569 0569 0569 0569 0569 0569 0569 0569 0569 0569 0569 0569 0569 0569 0569 0550 0551 0552 0569 0569 0569 0569 0569 0569 0569 0569 0569 0569 0569 0569 0569 0569 0550 0551 0551 0552 0569 0569 0569 0569 0569 0569 0569 0569 0569 0569 0569 0569 0569 0569 0225 0569 0569 0569 0569 0569 0569 0569 0569 0569 0569 0569 0569 0569 0000 0061 0063 0570 0570 0570 0063 0063 0063 0063 0063 0063 0063 0570 0570 0570 0570 0270 0061
0000 0569 0569 0569 0569 0569 0569 0569 0569 0569 0569 0569 0569 0569 0569 0569 0569 0569 0569 0561 0562 0563 0569 0569 0569 0569 0569 0550 0551 0551 0551 0552 0569 0569 0569 0569 0561 0562 0562 0563 0569 0569 0569 0569 0569 0569 0569 0569 0569 0569 0569 0569 0569 0569 0569 0569 0550 0551 0552 0569 0569 0569 0569 0569 0569 0569 0569 0561 0562 0563 0569 0569 0569 0569 0569 0550 0551 0551 0551 0552 0569 0569 0569 0569 0561 0562 0562 0563 0569 0569 0569 0569 0569 0569 0569 0569 0569 0569 0569 0569 0569 0569 0569 0569 0550 0551 0552 0569 0569 0569 0569 0569 0569 0569 0569 0561 0562 0563 0569 0569 0569 0569 0569 0550 0551 0551 0551 0552 0569 0569 0569 0569 0561 0562 0562 0563 0569 0569 0569 0569 0569 0569 0569 0569 0569 0569 0569 0569 0569 0569 0569 0569 0550 0551 0552 0569 0569 0569 0569 0569 0569 0569 0569 0561 0562 0563 0569 0569 0569 0569 0569 0550 0551 0551 0551 0552 0569 0569 0569 0569 0561 0562 0562 0563 0569 0569 0569 0569 0569 0569 0569 0569 0569 0569 0569 0569 0569 0288 0286 0569 0550 0551 0552 0569 0569 0569 0569 0569 0569 0569 0569 0569 0000 0061 0063 0570 0570 0570 0570 0570 0570 0570 0570 0570 0570 0570 0570 0570 0570 0270 0061
0000 0569 0569 0569 0569 0569 0569 0569 0569 0569 0569 0569 0569 0569 0569 0569 0569 0569 0569 0569 0569 0569 0569 0569 0569 0569 0569 0561 0562 0562 0562 0563 0569 0569 0569 0569 0569 0569 0569 0569 0569 0569 0569 0569 0569 0569 0569 0569 0569 0569 0569 0569 0569 0569 0569 0569 0561 0562 0563 0569 0569 0569 0569 0569 0569 0569 0569 0569 0569 0569 0569 0569 0569 0569 0569 0561 0562 0562 0562 0563 0569 0569 0569 0569 0569 0569 0569 0569 0569 0569 0569 0569 0569 0569 0569 0569 0569 0569 0569 0569 0569 0569 0569 0569 0561 0562 0563 0569 0569 0569 0569 0569 0569 0569 0569 0569 0569 0569 0569 0569 0569 0569 0569 0561 0562 0562 0562 0563 0569 0569 0569 0569 0569 0569 0569 0569 0569 0569 0569 0569 0569 0569 0569 0569 0569 0569 0569 0569 0569 0569 0569 0569 0561 0562 0563 0569 0569 0569 0569 0569 0569 0569 0569 0569 0569 0569 0569 0569 0569 0569 0569 0561 0562 0562 0562 0563 0569 0569 0569 0569 0569 0569 0569 0569 0569 0569 0569 0569 0569 0569 0569 0569 0569 0569 0569 0569 0569 0569 0286 0569 0561 0562 0563 0569 0569 0569 0569 0569 0569 0569 0569 0569 0000 0061 0063 0570 0570 0570 0570 0570 0570 0570 0570 0570 0570 0570 0570 0570 0570 0270 0061
0000 0569 0569 0569 0569 0569 0569 0569 0569 0569 0569 0569 0569 0569 0569 0569 0569 0569 0569 0569 0569 0569 0024 0569 0569 0569 0569 0569 0569 0569 0569 0569 0569 0569 0569 0569 0569 0569 0569 0569 0569 0569 0569 0569 0569 0569 0569 0569 0569 0569 0569 0569 0569 0569 0569 0569 0569 0569 0569 0569 0569 0569 0569 0569 0569 0569 0569 0569 0569 0569 0569 0569 0569 0569 0569 0569 0569 0569 0569 0569 0001 0001 0001 0001 0001 0001 0001 0001 0569 0569 0569 0001 0001 0001 0024 0569 0569 0569 0569 0569 0569 0569 0569 0569 0569 0569 0569 0569 0569 0024 0569 0569 0569 0569 0569 0569 0569 0569 0569 0569 0569 0001 0001 0001 0569 0569 0569 0569 0001 0024 0024 0001 0569 0569 0569 0569 0569 0569 0569 0569 0569 0569 0569 0569 0569 0569 0569 0569 0569 0569 0569 0569 0569 0569 0569 0569 0569 0569 0569 0569 0569 0569 0569 0569 0569 0569 0569 0569 0569 0569 0569 0569 0569 0569 0569 0569 0569 0569 0569 0569 0569 0569 0569 0569 0569 0569 0569 0569 0028 0028 0569 0569 0569 0569 0569 0569 0569 0569 0286 0569 0569 0569 0569 0569 0569 0569 0569 0569 0569 0569 0569 0569 0000 0061 0063 0570 0570 0570 0570 0570 0570 0570 0570 0570 0570 0570 0570 0570 0570 0270 0061
0000 0569 0569 0569 0569 0569 0569 0569 0569 0569 0569 0569 0569 0569 0569 0569 0569 0569 0569 0569 0569 0569 0569 0569 0569 0569 0569 0569 0569 0569 0569 0569 0569 0569 0569 0569 0569 0569 0569 0569 0569 0569 0569 0569 0569 0569 0569 0569 0569 0569 0569 0569 0569 0569 0569 0569 0569 0569 0569 0569 0569 0569 0569 0569 0569 0569 0569 0569 0569 0569 0569 0569 0569 0569 0569 0569 0569 0569 0569 0569 0569 0569 0569 0569 0569 0569 0569 0569 0569 0569 0569 0569 0569 0569 0569 0569 0569 0569 0569 0569 0569 0569 0569 0569 0569 0569 0569 0569 0569 0569 0569 0569 0569 0569 0569 0569 0569 0569 0569 0569 0569 0569 0569 0569 0569 0569 0569 0569 0569 0569 0569 0569 0569 0569 0569 0569 0569 0569 0569 0569 0569 0569 0569 0569 0569 0569 0569 0569 0569 0569 0569 0569 0569 0569 0569 0569 0569 0569 0569 0569 0569 0569 0569 0569 0569 0569 0569 0569 0569 0569 0569 0569 0569 0569 0569 0569 0569 0569 0569 0569 0569 0569 0569 0569 0569 0569 0569 0028 0028 0028 0569 0569 0569 0569 0569 0569 0569 0569 0286 0569 0569 0569 0569 0569 0569 0569 0569 0569 0569 0569 0569 0569 0000 0061 0063 0570 0570 0570 0570 0570 0570 0570 0570 0570 0570 0570 0570 0570 0570 0270 0061
0000 0569 0569 0569 0569 0569 0569 0569 0569 0569 0569 0569 0569 0569 0569 0569 0569 0569 0569 0569 0569 0569 0569 0569 0569 0569 0569 0569 0569 0569 0569 0569 0569 0569 0569 0569 0569 0569 0569 0569 0569 0569 0569 0569 0569 0569 0569 0569 0569 0569 0569 0569 0569 0569 0569 0569 0569 0569 0569 0569 0569 0569 0569 0569 0569 0569 0569 0569 0569 0569 0569 0569 0569 0569 0569 0569 0569 0569 0569 0569 0569 0569 0569 0569 0569 0569 0569 0569 0569 0569 0569 0569 0569 0569 0569 0569 0569 0569 0569 0569 0569 0569 0569 0569 0569 0569 0569 0569 0569 0569 0569 0569 0569 0569 0569 0569 0569 0569 0569 0569 0569 0569 0569 0569 0569 0569 0569 0569 0569 0569 0569 0569 0569 0569 0569 0569 0569 0569 0569 0569 0569 0569 0569 0569 0569 0569 0569 0569 0569 0569 0569 0569 0569 0569 0569 0569 0569 0569 0569 0569 0569 0569 0569 0569 0569 0569 0569 0569 0569 0569 0569 0569 0569 0569 0569 0569 0569 0569 0569 0569 0569 0569 0569 0569 0569 0569 0028 0028 0028 0028 0569 0569 0569 0569 0569 0569 0569 0569 0286 0569 0569 0569 0569 0569 0569 0569 0569 0569 0569 0569 0569 0569 0000 0061 0063 0570 0570 0570 0570 0570 0570 0570 0570 0570 0570 0570 0570 0570 0570 0270 0061
0000 0569 0569 0569 0569 0569 0569 0569 0569 0569 0569 0569 0569 0569 0569 0569 0569 0569 0569 0569 0569 0569 0569 0569 0569 0569 0569 0569 0569 0569 0569 0569 0569 0569 0569 0569 0569 0569 0569 0569 0569 0569 0569 0569 0569 0569 0569 0569 0569 0569 0569 0569 0569 0569 0569 0569 0569 0569 0569 0569 0569 0569 0569 0569 0569 0569 0569 0569 0569 0569 0569 0569 0569 0569 0569 0569 0569 0569 0569 0569 0569 0569 0569 0569 0569 0569 0569 0569 0569 0569 0569 0569 0569 0569 0569 0569 0569 0569 0569 0569 0569 0569 0569 0569 0569 0569 0569 0569 0569 0569 0569 0569 0569 0569 0569 0569 0569 0569 0569 0569 0569 0569 0569 0569 0569 0569 0569 0569 0569 0569 0569 0569 0569 0569 0569 0569 0569 0569 0569 0569 0569 0569 0569 0569 0569 0569 0569 0569 0569 0569 0569 0569 0569 0569 0569 0569 0569 0569 0569 0569 0569 0569 0569 0569 0569 0569 0569 0569 0569 0569 0569 0569 0569 0569 0569 0569 0569 0569 0569 0569 0569 0569 0569 0569 0569 0028 0028 0028 0028 0028 0569 0569 0569 0569 0569 0569 0569 0569 0286 0569 0569 0569 0569 0011 0011 0011 0569 0569 0569 0569 0569 0569 0000 0061 0063 0570 0570 0570 0570 0570 0570 0570 0570 0570 0570 0570 0570 0570 0570 0270 0061
0000 0569 0569 0569 0569 0569 0569 0569 0569 0569 0569 0569 0569 0569 0569 0569 0024 0569 0569 0569 0001 0024 0001 0024 0001 0569 0569 0569 0569 0569 0569 0569 0569 0569 0569 0569 0569 0569 0569 0569 0569 0569 0569 0569 0569 0569 0244 0245 0569 0569 0569 0569 0569 0569 0569 0569 0569 0244 0245 0569 0569 0569 0569 0569 0569 0569 0569 0569 0569 0569 0569 0569 0569 0569 0569 0569 0569 0001 0024 0001 0569 0569 0569 0569 0569 0569 0569 0569 0569 0569 0569 0569 0569 0569 0001 0569 0569 0569 0569 0569 0001 0001 0569 0569 0569 0569 0024 0569 0569 0024 0569 0569 0024 0569 0569 0569 0569 0569 0001 0569 0569 0569 0569 0569 0569 0569 0569 0569 0569 0001 0001 0569 0569 0569 0569 0569 0569 0028 0569 0569 0028 0569 0569 0569 0569 0569 0569 0569 0569 0569 0569 0028 0028 0569 0569 0028 0569 0569 0569 0569 0569 0569 0569 0569 0569 0569 0569 0569 0001 0001 0024 0001 0569 0569 0569 0569 0569 0569 0569 0569 0569 0569 0569 0569 0028 0028 0028 0028 0028 0028 0569 0569 0569 0569 0569 0569 0569 0569 0286 0569 0569 0569 0569 0012 0002 0014 0569 0569 0569 0569 0569 0569 0000 0061 0063 0570 0570 0570 0570 0570 0570 0570 0570 0570 0570 0570 0570 0570 0570 0270 0061
0000 0569 0569 0253 0569 0569 0569 0569 0569 0569 0569 0569 0569 0569 0569 0569 0569 0569 0569 0569 0569 0569 0569 0569 0569 0569 0569 0569 0569 0569 0569 0569 0569 0569 0569 0569 0569 0569 0244 0245 0569 0569 0569 0569 0569 0569 0270 0271 0569 0569 0253 0569 0569 0569 0569 0569 0569 0270 0271 0569 0569 0569 0569 0569 0569 0569 0569 0569 0569 0569 0569 0569 0569 0569 0569 0569 0569 0569 0569 0569 0569 0569 0569 0569 0569 0569 0569 0569 0569 0569 0569 0569 0569 0569 0569 0569 0569 0569 0253 0569 0569 0569 0569 0569 0569 0569 0569 0569 0569 0569 0569 0569 0569 0569 0569 0569 0569 0569 0569 0569 0569 0569 0569 0569 0569 0569 0569 0569 0569 0569 0569 0569 0569 0569 0569 0569 0028 0028 0569 0569 0028 0028 0569 0569 0569 0569 0253 0569 0569 0569 0028 0028 0028 0569 0569 0028 0028 0569 0569 0569 0569 0569 0569 0569 0569 0569 0569 0569 0569 0569 0569 0569 0569 0569 0569 0569 0569 0569 0569 0569 0569 0569 0569 0028 0028 0028 0028 0028 0028 0028 0569 0569 0569 0569 0253 0569 0569 0569 0286 0569 0569 0569 0011 0038 0038 0038 0011 0569 0569 0569 0569 0569 0000 0061 0063 0570 0570 0570 0063 0063 0063 0063 0063 0063 0063 0570 0570 0570 0570 0270 0061
0000 0569 0252 0278 0254 0569 0569 0569 0569 0569 0569 0569 0569 0569 0569 0569 0569 0253 0569 0569 0569 0569 0569 0569 0569 0569 0569 0569 0244 0245 0569 0569 0569 0569 0569 0569 0569 0569 0270 0271 0569 0569 0569 0569 0569 0569 0270 0271 0569 0252 0278 0254 0569 0569 0569 0569 0569 0270 0271 0569 0569 0569 0569 0569 0569 0253 0569 0569 0569 0569 0569 0569 0569 0569 0569 0569 0569 0569 0569 0569 0569 0569 0569 0569 0569 0569 0569 0569 0569 0569 0569 0569 0569 0569 0569 0569 0569 0252 0278 0254 0569 0569 0569 0569 0569 0569 0569 0569 0569 0569 0569 0569 0569 0253 0569 0569 0569 0569 0569 0569 0569 0569 0569 0569 0569 0569 0569 0569 0569 0569 0569 0569 0569 0569 0569 0028 0028 0028 0569 0569 0028 0028 0028 0569 0569 0252 0278 0254 0569 0028 0028 0028 0028 0569 0569 0028 0028 0028 0569 0569 0569 0253 0569 0244 0245 0569 0569 0569 0569 0569 0569 0569 0569 0569 0569 0569 0569 0569 0569 0244 0245 0569 0028 0028 0028 0028 0028 0028 0028 0028 0569 0569 0569 0252 0278 0254 0569 0569 0286 0569 0569 0569 0002 0002 0039 0002 0002 0569 0569 0253 0569 0569 0000 0061 0063 0570 0570 0570 0063 0063 0063 0063 0063 0063 0063 0570 0570 0246 0247 0248 0061
0000 0252 0278 0279 0278 0254 0569 0569 0569 0569 0569 0569 0281 0282 0282 0283 0252 0278 0254 0569 0569 0569 0569 0281 0282 0283 0569 0569 0270 0271 0569 0569 0569 0569 0569 0569 0569 0569 0270 0271 0569 0281 0282 0282 0283 0569 0270 0271 0252 0278 0279 0278 0254 0569 0569 0569 0569 0270 0271 0281 0282 0282 0282 0283 0252 0278 0254 0569 0569 0569 0569 0281 0282 0283 0569 0569 0569 0569 0569 0569 0569 0569 0569 0569 0569 0569 0569 0569 0569 0281 0282 0282 0283 0569 0569 0569 0252 0278 0279 0278 0254 0569 0569 0569 0569 0569 0569 0281 0282 0282 0282 0283 0252 0278 0254 0569 0569 0569 0569 0281 0282 0283 0569 0569 0569 0569 0569 0569 0569 0569 0569 0569 0569 0569 0028 0028 0028 0028 0282 0282 0028 0028 0028 0028 0252 0278 0279 0278 0028 0028 0028 0028 0028 0569 0569 0028 0028 0028 0028 0283 0252 0278 0254 0270 0271 0569 0569 0281 0282 0283 0569 0569 0569 0569 0569 0569 0569 0569 0569 0270 0271 0028 0028 0028 0028 0028 0028 0028 0028 0028 0569 0569 0252 0278 0279 0278 0254 0569 0028 0569 0569 0569 0002 0002 0040 0002 0002 0283 0252 0278 0254 0569 0000 0061 0063 0570 0570 0570 0063 0063 0063 0063 0063 0063 0063 0570 0570 0272 0273 0274 0061
0000 0000 0000 0000 0000 0000 0000 0000 0000 0000 0000 0000 0000 0000 0000 0000 0000 0000 0000 0000 0000 0000 0000 0000 0000 0000 0000 0000 0000 0000 0000 0000 0000 0000 0000 0000 0000 0000 0000 0000 0000 0000 0000 0000 0000 0000 0000 0000 0000 0000 0000 0000 0000 0000 0000 0000 0000 0000 0000 0000 0000 0000 0000 0000 0000 0000 0000 0000 0000 0569 0569 0000 0000 0000 0000 0000 0000 0000 0000 0000 0000 0000 0000 0000 0000 0000 0569 0569 0569 0000 0000 0000 0000 0000 0000 0000 0000 0000 0000 0000 0000 0000 0000 0000 0000 0000 0000 0000 0000 0000 0000 0000 0000 0000 0000 0000 0000 0000 0000 0000 0000 0000 0000 0000 0000 0000 0000 0000 0000 0000 0000 0000 0000 0000 0000 0000 0000 0000 0000 0000 0000 0000 0000 0000 0000 0000 0000 0000 0000 0000 0000 0000 0000 0569 0569 0000 0000 0000 0000 0000 0000 0000 0000 0000 0000 0000 0000 0000 0000 0000 0000 0000 0000 0000 0000 0000 0000 0000 0000 0000 0000 0000 0000 0000 0000 0000 0000 0000 0000 0000 0000 0000 0000 0000 0000 0000 0000 0000 0000 0000 0000 0000 0000 0000 0000 0000 0000 0000 0000 0000 0000 0000 0000 0061 0061 0061 0061 0061 0061 0061 0061 0061 0061 0061 0061 0061 0061 0061 0061 0061 0061
0000 0000 0000 0000 0000 0000 0000 0000 0000 0000 0000 0000 0000 0000 0000 0000 0000 0000 0000 0000 0000 0000 0000 0000 0000 0000 0000 0000 0000 0000 0000 0000 0000 0000 0000 0000 0000 0000 0000 0000 0000 0000 0000 0000 0000 0000 0000 0000 0000 0000 0000 0000 0000 0000 0000 0000 0000 0000 0000 0000 0000 0000 0000 0000 0000 0000 0000 0000 0000 0569 0569 0000 0000 0000 0000 0000 0000 0000 0000 0000 0000 0000 0000 0000 0000 0000 0569 0569 0569 0000 0000 0000 0000 0000 0000 0000 0000 0000 0000 0000 0000 0000 0000 0000 0000 0000 0000 0000 0000 0000 0000 0000 0000 0000 0000 0000 0000 0000 0000 0000 0000 0000 0000 0000 0000 0000 0000 0000 0000 0000 0000 0000 0000 0000 0000 0000 0000 0000 0000 0000 0000 0000 0000 0000 0000 0000 0000 0000 0000 0000 0000 0000 0000 0569 0569 0000 0000 0000 0000 0000 0000 0000 0000 0000 0000 0000 0000 0000 0000 0000 0000 0000 0000 0000 0000 0000 0000 0000 0000 0000 0000 0000 0000 0000 0000 0000 0000 0000 0000 0000 0000 0000 0000 0000 0000 0000 0000 0000 0000 0000 0000 0000 0000 0000 0000 0000 0000 0000 0000 0000 0000 0000 0000 0061 0061 0061 0061 0061 0061 0061 0061 0061 0061 0061 0061 0061 0061 0061 0061 0061 0061