56 15
128 352
RunningAbout
0569 0569 0569 0569 0569 0569 0569 0569 0569 0569 0571 0569 0569 0569 0569 0569 0569 0571 0569 0569 0571 0569 0569 0569 0569 0569 0569 0569 0569 0569 0571 0569 0569 0569 0569 0569 0569 0569 0569 0569 0569 0569 0569 0569 0569 0569 0569 0569 0569 0569 0569 0569 0569 0569 0569 0569
0569 0569 0569 0569 0569 0569 0569 0569 0569 0569 0571 0569 0569 0569 0569 0569 0569 0571 0569 0569 0571 0569 0569 0569 0569 0569 0569 0569 0569 0569 0571 0569 0569 0569 0569 0569 0569 0569 0569 0569 0569 0569 0569 0569 0569 0569 0569 0569 0569 0569 0569 0569 0569 0569 0569 0569
0569 0569 0569 0569 0569 0569 0569 0569 0569 0569 0571 0569 0569 0569 0569 0569 0569 0571 0569 0569 0571 0569 0569 0569 0569 0569 0569 0569 0569 0569 0571 0569 0569 0569 0569 0569 0569 0569 0569 0569 0569 0569 0569 0569 0569 0569 0569 0569 0569 0569 0569 0569 0569 0569 0569 0569
0569 0569 0569 0569 0569 0571 0571 0571 0571 0571 0571 0569 0569 0569 0569 0569 0569 0571 0571 0571 0571 0569 0569 0569 0569 0569 0569 0569 0569 0569 0571 0569 0569 0569 0569 0569 0569 0569 0569 0569 0569 0569 0569 0569 0569 0569 0569 0569 0569 0569 0569 0569 0569 0569 0569 0569
0569 0569 0569 0569 0569 0571 0569 0569 0569 0569 0569 0569 0569 0569 0569 0569 0569 0569 0569 0569 0569 0569 0569 0569 0569 0569 0569 0569 0569 0569 0571 0571 0571 0571 0571 0571 0571 0571 0571 0571 0571 0571 0571 0571 0571 0571 0571 0571 0571 0571 0571 0571 0571 0571 0571 0569
0569 0569 0569 0569 0569 0571 0569 0569 0569 0569 0569 0569 0569 0569 0569 0569 0569 0569 0569 0569 0569 0569 0569 0569 0569 0569 0569 0569 0569 0569 0569 0569 0569 0569 0569 0569 0569 0569 0569 0569 0569 0569 0569 0569 0569 0569 0569 0569 0569 0569 0569 0569 0569 0569 0571 0569
0569 0569 0569 0569 0569 0571 0569 0569 0569 0569 0569 0569 0569 0569 0569 0569 0569 0569 0569 0569 0569 0569 0569 0569 0569 0569 0569 0569 0569 0569 0569 0569 0569 0569 0569 0569 0569 0569 0569 0569 0569 0569 0569 0569 0569 0569 0569 0569 0569 0569 0569 0569 0569 0569 0571 0569
0569 0569 0569 0569 0569 0571 0569 0569 0569 0569 0569 0569 0571 0571 0571 0571 0569 0569 0569 0569 0569 0569 0569 0569 0569 0571 0571 0571 0571 0571 0571 0571 0571 0571 0571 0571 0571 0571 0571 0571 0571 0571 0571 0571 0571 0571 0571 0571 0571 0571 0571 0571 0571 0571 0571 0569
0569 0569 0569 0569 0569 0571 0569 0569 0569 0569 0569 0569 0569 0569 0569 0569 0569 0569 0569 0569 0569 0569 0569 0569 0569 0571 0569 0569 0569 0569 0569 0569 0569 0569 0569 0569 0569 0569 0569 0569 0569 0569 0569 0569 0569 0569 0569 0569 0569 0569 0569 0569 0569 0569 0569 0569
0569 0569 0569 0569 0569 0571 0569 0569 0569 0569 0569 0569 0569 0569 0569 0569 0569 0569 0569 0569 0569 0569 0569 0569 0569 0571 0569 0569 0569 0569 0569 0569 0569 0569 0569 0569 0569 0569 0569 0569 0569 0569 0569 0569 0569 0569 0569 0569 0569 0569 0569 0569 0569 0569 0569 0569
0569 0571 0571 0571 0571 0571 0569 0569 0569 0569 0569 0569 0569 0569 0569 0569 0569 0569 0569 0571 0571 0571 0571 0569 0569 0571 0571 0571 0571 0571 0571 0571 0569 0569 0569 0569 0569 0569 0569 0569 0569 0569 0569 0569 0569 0569 0569 0569 0569 0569 0569 0569 0569 0569 0569 0569
0569 0571 0569 0569 0569 0569 0569 0569 0569 0569 0569 0569 0569 0569 0569 0569 0569 0569 0569 0569 0569 0569 0569 0569 0569 0569 0569 0569 0569 0569 0569 0571 0569 0569 0569 0569 0569 0569 0569 0569 0569 0569 0569 0569 0569 0569 0569 0569 0569 0569 0569 0569 0569 0569 0569 0569
0569 0571 0569 0569 0569 0569 0569 0569 0569 0569 0569 0569 0569 0569 0569 0569 0569 0569 0569 0569 0569 0569 0569 0569 0569 0569 0569 0569 0569 0569 0569 0571 0569 0569 0569 0569 0569 0569 0569 0569 0569 0569 0569 0569 0569 0569 0569 0569 0569 0569 0569 0569 0569 0569 0569 0569
0569 0571 0571 0571 0571 0571 0571 0571 0571 0571 0571 0571 0571 0571 0571 0571 0571 0571 0571 0571 0571 0571 0571 0571 0571 0571 0571 0571 0571 0571 0571 0571 0569 0569 0569 0569 0569 0569 0569 0569 0569 0569 0569 0569 0569 0569 0569 0569 0569 0569 0569 0569 0569 0569 0569 0569
0569 0569 0569 0569 0569 0569 0569 0569 0569 0569 0569 0569 0569 0569 0569 0569 0569 0569 0569 0569 0569 0569 0569 0569 0569 0569 0569 0569 0569 0569 0569 0569 0569 0569 0569 0569 0569 0569 0569 0569 0569 0569 0569 0569 0569 0569 0569 0569 0569 0569 0569 0569 0569 0569 0569 0569
